pitcher,outs,innings,walks,hits,runners,whip,runs
425794,442,147.33333333333334,34,129,163,1.1567653214458855,-0.09701034552223109
425844,428,142.66666666666666,29,134,163,1.1860998018899265,-0.07886340628837873
429722,146,48.666666666666664,14,48,62,1.3026622980723,-0.006755344268913888
431148,21,7.0,1,8,9,1.3290823859441898,0.009588689165692887
433589,181,60.333333333333336,9,54,63,1.1630450045636451,-0.09312559875934845
445213,90,30.0,6,46,52,1.5032924564288883,0.11735877798801497
445276,141,47.0,26,30,56,1.259327905943194,-0.033562929363285754
445926,55,18.333333333333332,6,17,23,1.3112749129076147,-0.0014273958718329371
446099,1,0.3333333333333333,1,3,4,1.4216830072355178,0.06687342106323935
446321,123,41.0,14,46,60,1.3996434802397024,0.05323929661031568
446372,158,52.666666666666664,23,44,67,1.3004219128932593,-0.0081412946279813
448179,344,114.66666666666667,43,110,153,1.3348643925765553,0.013165562572652556
448281,111,37.0,15,41,56,1.420044647433342,0.06585989652408863
448855,164,54.666666666666664,35,53,88,1.4920325853087286,0.11039318003279175
450203,400,133.33333333333334,45,116,161,1.238021768617123,-0.04674336322513273
451584,107,35.666666666666664,15,36,51,1.3797114883262847,0.04090893859520017
452657,269,89.66666666666667,32,115,147,1.5437702640111162,0.14239921856835858
453178,114,38.0,9,34,43,1.2383335488841027,-0.046550489259971184
453192,77,25.666666666666668,11,38,49,1.555725699067909,0.1497951073042697
453265,121,40.333333333333336,13,27,40,1.1662387746629663,-0.09114986402527547
453268,140,46.666666666666664,21,57,78,1.5140296358631458,0.12400102764735821
453281,146,48.666666666666664,14,60,74,1.4359606033418755,0.07570584846695005
453284,78,26.0,7,27,34,1.325332732681007,0.007269073175056984
453286,381,127.0,31,91,122,1.052943639871928,-0.16123666615787424
453343,148,49.333333333333336,15,40,55,1.2159006480119265,-0.06042796323613342
453562,259,86.33333333333333,36,117,153,1.6310588005060211,0.19639778079299575
455119,93,31.0,4,36,40,1.3166720114460504,0.0019113651266084997
456034,164,54.666666666666664,14,65,79,1.3983056754759768,0.05241170186902144
456501,310,103.33333333333333,23,112,135,1.3150183037214995,0.0008883460332509419
456713,9,3.0,1,4,5,1.3587581988652364,0.027946783996133373
457915,17,5.666666666666667,3,11,14,1.4730973619282592,0.09867944442665799
457918,345,115.0,36,139,175,1.4727222913503577,0.09844741771670584
458676,50,16.666666666666668,10,26,36,1.5729864416946724,0.16047297317534126
458677,73,24.333333333333332,12,22,34,1.3589585088172158,0.028070700031852525
458681,357,119.0,35,91,126,1.1304179652715938,-0.11330938556760073
458708,139,46.333333333333336,5,65,70,1.4285547085703814,0.07112440300221845
459429,151,50.333333333333336,8,35,43,1.0717643738015745,-0.14959375618340498
461325,27,9.0,1,9,10,1.2961541869738586,-0.010781401483592301
461872,37,12.333333333333334,1,21,22,1.439187167553191,0.0777018703425909
465657,91,30.333333333333332,8,32,40,1.328916082610265,0.009485810353815682
467008,6,2.0,2,2,4,1.3670327182157813,0.03306557926950171
468504,128,42.666666666666664,18,38,56,1.324274948618406,0.006614705249803454
471911,34,11.333333333333334,3,18,21,1.4475224214297204,0.08285823729733066
472551,7,2.3333333333333335,2,4,6,1.4023797364926969,0.05493200345903804
472610,39,13.0,1,10,11,1.2191702103206525,-0.05840534181452928
474463,230,76.66666666666667,20,82,102,1.332533054054769,0.011723346523553002
475054,2,0.6666666666666666,1,1,2,1.3628139102734267,0.03045573412446001
475479,31,10.333333333333334,4,9,13,1.32075830038502,0.004439231171787128
476454,3,1.0,1,1,2,1.3520890836686958,0.023821126190601394
476594,27,9.0,9,11,20,1.4947363757199819,0.1120658028149707
476595,165,55.0,10,60,70,1.3000657602252517,-0.008361618312821673
477132,318,106.0,19,88,107,1.1012061400188353,-0.13138044766747203
488748,47,15.666666666666666,12,18,30,1.4953517489631423,0.11244648591147466
488984,24,8.0,3,5,8,1.281893878436655,-0.019603134425966395
489119,396,132.0,42,121,163,1.2590806011948734,-0.03371591738871127
489265,132,44.0,12,32,44,1.163002849151789,-0.09315167700194049
489334,202,67.33333333333333,9,69,78,1.2261480036949604,-0.054088729062805374
491624,128,42.666666666666664,11,59,70,1.4908947035799827,0.10968926197205597
491703,3,1.0,1,5,6,1.446524514864836,0.08224091087736674
493603,139,46.333333333333336,25,44,69,1.4171509408998846,0.06406978755238135
500610,128,42.666666666666664,12,33,45,1.1933594268628815,-0.07437244646053776
500779,149,49.666666666666664,29,57,86,1.5520187857871204,0.14750193118410782
501381,253,84.33333333333333,16,88,104,1.2671653554488909,-0.028714514877146158
501593,15,5.0,3,8,11,1.4295670253932191,0.07175064391705199
501625,140,46.666666666666664,10,34,44,1.1277698075139029,-0.1149475927961946
501789,18,6.0,3,7,10,1.3782637783033531,0.04001335410157014
501925,84,28.0,5,41,46,1.4601329224276034,0.09065936388464346
501985,405,135.0,40,137,177,1.3170468806930893,0.002143267288967632
502042,13,4.333333333333333,1,7,8,1.384766387999062,0.044036008030436946
502043,382,127.33333333333333,50,114,164,1.2998399619082888,-0.008501301998198318
502154,50,16.666666666666668,13,17,30,1.4695803308441828,0.096503733508987
502171,233,77.66666666666667,26,75,101,1.3129358307214731,-0.0003999164624733931
502179,212,70.66666666666667,13,72,85,1.252150012945886,-0.038003328036707806
502202,148,49.333333333333336,21,36,57,1.237953719057061,-0.046785460143593305
502210,2,0.6666666666666666,1,2,3,1.38661003451022,0.04517652733400901
502239,111,37.0,14,43,57,1.4328067517853276,0.0737548082002426
502327,79,26.333333333333332,11,27,38,1.3778989281052643,0.03978764993793893
502522,45,15.0,5,19,24,1.4065766136694746,0.057528281761775046
502624,143,47.666666666666664,19,54,73,1.4408577357620473,0.07873531969343084
502706,94,31.333333333333332,15,40,55,1.516989054567554,0.1258317875784526
503285,32,10.666666666666666,4,10,14,1.3315177767294246,0.01109527417832501
503449,167,55.666666666666664,22,51,73,1.3220530745527295,0.005240206262782987
503569,95,31.666666666666668,24,30,54,1.4963702137540786,0.11307653009133312
506433,393,131.0,30,113,143,1.1503474415666455,-0.10098058376800134
506702,11,3.6666666666666665,1,5,6,1.3608495708537331,0.029240551597132125
517008,138,46.0,17,47,64,1.3653220409977165,0.03200731762467124
518397,46,15.333333333333334,3,16,19,1.3101076013633175,-0.002149519848146153
518516,292,97.33333333333333,21,99,120,1.263753800614533,-0.030824975922813858
518553,150,50.0,26,49,75,1.4259491723285675,0.06951256235816838
518617,133,44.333333333333336,22,35,57,1.310187885352441,-0.0020998544492701887
518633,183,61.0,21,52,73,1.2531672057964443,-0.03737407070646803
518774,324,108.0,33,138,171,1.5149637446259288,0.12457888737759504
518813,141,47.0,23,46,69,1.4064583249161648,0.057455105800044426
518858,57,19.0,8,17,25,1.329927546946621,0.010111523902213926
518876,423,141.0,30,146,176,1.2682290009836978,-0.02805652091937627
518886,135,45.0,14,22,36,1.0568967477238198,-0.15879118879174214
519008,42,14.0,2,11,13,1.233275563258232,-0.049679467732028026
519043,167,55.666666666666664,22,62,84,1.4354274939060847,0.0753760555273838
519076,87,29.0,13,18,31,1.2261812646667087,-0.05406815311177304
519141,76,25.333333333333332,9,19,28,1.2486132764146587,-0.04019122916694129
519151,144,48.0,8,32,40,1.0661776088769481,-0.1530498488793166
519293,147,49.0,18,42,60,1.2757222578892782,-0.02342103136337037
519326,123,41.0,15,36,51,1.2903631300050928,-0.014363873622904366
519443,80,26.666666666666668,19,36,55,1.6210599510630337,0.19021227791366346
519455,16,5.333333333333333,2,9,11,1.4193610046543628,0.06543698042739954
521230,154,51.333333333333336,5,36,41,1.0386242953220455,-0.17009492004483207
523260,89,29.666666666666668,8,25,33,1.2428312935085821,-0.04376808789630926
527048,303,101.0,32,130,162,1.5262364351047888,0.13155241566326326
527054,15,5.0,3,4,7,1.3432801339930305,0.018371720847175976
528748,47,15.666666666666666,7,13,20,1.319985914390797,0.003961416617376257
533167,180,60.0,26,76,102,1.5516485354911704,0.1472728864040328
534910,10,3.3333333333333335,4,6,10,1.4605046379966247,0.09088931511409082
541640,68,22.666666666666668,4,22,26,1.2693811551677268,-0.027343773611460342
542585,151,50.333333333333336,21,40,61,1.268077361080018,-0.028150328618570142
542881,355,118.33333333333333,27,117,144,1.2478553425025007,-0.04066010335318926
542882,112,37.333333333333336,11,58,69,1.579233888117043,0.16433777762653234
542888,60,20.0,10,29,39,1.536425189634984,0.1378553979056384
542914,135,45.0,14,42,56,1.2884935357523017,-0.015520444756389473
542947,131,43.666666666666664,2,46,48,1.2146081096684125,-0.061227555198292705
542960,88,29.333333333333332,15,27,42,1.3760076254442388,0.038617649517173946
543022,84,28.0,20,23,43,1.4168784461072255,0.06390121642485247
543037,410,136.66666666666666,29,104,133,1.0575584470273292,-0.1583818473999704
543045,6,2.0,1,1,2,1.3209040478371392,0.004529393673970872
543056,56,18.666666666666668,3,17,20,1.2540126233152182,-0.03685107728343151
543101,392,130.66666666666666,34,108,142,1.1467633364029,-0.10319778815102432
543135,398,132.66666666666666,24,140,164,1.260003538579491,-0.033144968512788475
543243,271,90.33333333333333,36,94,130,1.4068643728949095,0.05770629579505271
543272,145,48.333333333333336,15,42,57,1.2517562538557978,-0.038246915861426145
543278,3,1.0,1,3,4,1.399306799266766,0.053031018533984176
543294,413,137.66666666666666,27,163,190,1.3700447665955453,0.034928897047407204
543339,104,34.666666666666664,9,27,36,1.200552917490858,-0.06992239875799888
543351,44,14.666666666666666,6,10,16,1.2721487228094208,-0.025631696865625164
543456,4,1.3333333333333333,1,3,4,1.388380771200702,0.04627194305758486
543475,389,129.66666666666666,43,154,197,1.4750615763546797,0.09989454963046429
543507,136,45.333333333333336,15,42,57,1.2950744570784407,-0.01144934557206867
543521,139,46.333333333333336,8,34,42,1.1092492137964722,-0.12640482959321975
543548,43,14.333333333333334,3,20,23,1.4054582458614442,0.05683643543123784
543606,221,73.66666666666667,25,68,93,1.289042860246423,-0.015180620833702196
543699,21,7.0,2,7,9,1.3290823859441898,0.009588689165692887
543766,160,53.333333333333336,32,46,78,1.407434460723559,0.05805896436214031
543883,6,2.0,1,3,4,1.3670327182157813,0.03306557926950171
543901,29,9.666666666666666,4,16,20,1.4752063947386829,0.09998413739117007
544727,125,41.666666666666664,19,44,63,1.4245388485187254,0.06864010577840784
544931,65,21.666666666666668,12,17,29,1.3371236795151373,0.014563205965877013
545333,320,106.66666666666667,36,74,110,1.1165135761679241,-0.12191093910898587
545343,72,24.0,9,16,25,1.2281842078312222,-0.052829089479314195
546991,3,1.0,1,2,3,1.3756979414677308,0.038426072362292674
547001,92,30.666666666666668,16,25,41,1.3366500418202654,0.014270203521736247
547176,17,5.666666666666667,1,6,7,1.324236097931296,0.006590671380871438
547179,29,9.666666666666666,6,4,10,1.2792188483873221,-0.02125796543095293
547942,271,90.33333333333333,30,84,114,1.2853672090485837,-0.017454457558346737
547943,395,131.66666666666666,28,128,156,1.2210493467372971,-0.057242867693672705
547973,118,39.333333333333336,26,27,53,1.341801832690914,0.017457211931635186
548384,99,33.0,12,36,48,1.3888462138579158,0.04655987587553323
548389,279,93.0,28,88,116,1.2747414428716612,-0.024027784585343936
552640,162,54.0,10,39,49,1.09347434427572,-0.1361635024683412
553902,9,3.0,1,1,2,1.2911251056295516,-0.01389249914667634
554340,128,42.666666666666664,9,37,46,1.2052608379315655,-0.06700997812323406
554430,484,161.33333333333334,34,130,164,1.0818001492639173,-0.14338541007592454
554431,138,46.0,26,27,53,1.2394019421046447,-0.04588955828190189
570240,5,1.6666666666666667,4,7,11,1.5403252572187185,0.14026806342343945
570257,102,34.0,13,39,52,1.4234966691339745,0.06799539124180909
570488,102,34.0,16,35,51,1.410226498889711,0.05978617909963713
570632,239,79.66666666666667,37,99,136,1.5804383254551753,0.1650828684157749
570663,146,48.666666666666664,26,50,76,1.4581769875534714,0.08944938058959395
570666,134,44.666666666666664,17,40,57,1.3051110338781713,-0.005240503740080449
571479,7,2.3333333333333335,1,6,7,1.4252681033602284,0.06909123847598508
571510,210,70.0,19,72,91,1.3135270946620128,-3.4147898049341485e-05
571521,133,44.333333333333336,21,36,57,1.310187885352441,-0.0020998544492701887
571578,379,126.33333333333333,40,144,184,1.4268588641649411,0.07007531725364691
571656,107,35.666666666666664,20,45,65,1.5614738427669312,0.15335103237383396
571666,28,9.333333333333334,4,15,19,1.4651795381920292,0.09378130871636936
571670,143,47.666666666666664,19,41,60,1.294829124520055,-0.011601113558469711
571676,44,14.666666666666666,9,22,31,1.5398927908625315,0.140000530453105
571710,111,37.0,16,29,45,1.279661499561498,-0.020984131913605042
571735,80,26.666666666666668,8,31,39,1.3858476394145929,0.04470489336391292
571760,326,108.66666666666667,37,111,148,1.3549224724348088,0.02557392129677738
571800,6,2.0,3,5,8,1.4592900589730653,0.09013795046056339
571871,33,11.0,4,16,20,1.4376384958919983,0.07674382881250608
571882,44,14.666666666666666,8,16,24,1.414945559104413,0.06270549103769751
571901,115,38.333333333333336,8,32,40,1.1955080465434018,-0.07304326420849683
571927,316,105.33333333333333,32,120,152,1.4129795305004362,0.06148926354471562
571945,12,4.0,1,4,5,1.3288012199321162,0.009414753835716438
571946,6,2.0,5,7,12,1.5515473997303495,0.1472103216516253
571948,38,12.666666666666666,2,21,23,1.4488175968678496,0.08365946062282104
572070,338,112.66666666666667,48,143,191,1.598912989943998,0.1765116924061647
572125,42,14.0,6,13,19,1.34166297206884,0.017371309770335297
572143,108,36.0,9,36,45,1.2962037875597752,-0.010750717496524342
572193,153,51.0,14,30,44,1.074855536014533,-0.14768149689019716
572888,51,17.0,9,23,32,1.4954579516432425,0.11251218516890404
572955,122,40.666666666666664,18,29,47,1.2468405734026058,-0.041287861299245665
572971,390,130.0,44,135,179,1.3671483368965993,0.03313710346707888
573009,78,26.0,13,33,46,1.5034879792244957,0.1174797325860516
573062,24,8.0,8,5,13,1.3831966657324446,0.04306494414400919
573124,123,41.0,6,38,44,1.205367302044841,-0.06694411713763104
573127,9,3.0,1,4,5,1.3587581988652364,0.027946783996133373
573186,397,132.33333333333334,28,123,151,1.187575788716473,-0.07795032915710298
573204,137,45.666666666666664,14,40,54,1.2556404471336273,-0.03584407052998184
573668,57,19.0,9,13,22,1.2802232736951054,-0.020636606376714495
579328,389,129.66666666666666,47,113,160,1.258717228855306,-0.03394070731734067
592094,23,7.666666666666667,6,12,18,1.494593216944894,0.11197724172396162
592135,44,14.666666666666666,10,19,29,1.5041935817887833,0.1179162334772742
592145,31,10.333333333333334,8,12,20,1.4561801826688991,0.08821411422885794
592165,9,3.0,2,3,5,1.3587581988652364,0.027946783996133373
592169,40,13.333333333333334,7,18,25,1.4677262750793478,0.09535677481766758
592222,97,32.333333333333336,14,37,51,1.4421218360179238,0.07951731924418637
592233,71,23.666666666666668,9,37,46,1.557439712321058,0.1508554326920074
592254,56,18.666666666666668,11,24,35,1.5039141198248491,0.11774335230805222
592273,2,0.6666666666666666,1,4,5,1.4342022829838064,0.07461811375310723
592288,53,17.666666666666668,4,13,17,1.2244314745373166,-0.05515061084306461
592314,367,122.33333333333333,31,138,169,1.3700896873211021,0.03495668597240875
592332,429,143.0,44,98,142,1.070045795170691,-0.1506569058117999
592346,267,89.0,24,113,137,1.4749529319138739,0.09982733984745273
592351,355,118.33333333333333,45,111,156,1.3230007880044483,0.005826482145604772
592390,127,42.333333333333336,19,34,53,1.2937030125299915,-0.012297750606232616
592407,3,1.0,1,2,3,1.3756979414677308,0.038426072362292674
592426,135,45.0,21,36,57,1.300073375153726,-0.008356907554621817
592464,6,2.0,1,6,7,1.4362257237837444,0.07586985766279808
592473,30,10.0,5,16,21,1.4851030923356296,0.10610644694596871
592612,43,14.333333333333334,5,15,20,1.351588916844281,0.02351171225750781
592644,166,55.333333333333336,26,68,94,1.5437990059210918,0.14241699893078186
592662,408,136.0,36,111,147,1.1404705414673788,-0.10709064616580444
592717,106,35.333333333333336,15,36,51,1.3857083840035374,0.044618746977675317
592741,109,36.333333333333336,19,29,48,1.3292572255663277,0.009696848708680594
592761,276,92.0,51,85,136,1.4342737064710742,0.07466229785535483
592767,312,104.0,36,109,145,1.3777832353528066,0.03971607991805559
592773,153,51.0,28,39,67,1.3238892217304754,0.00637608631774178
592791,351,117.0,35,115,150,1.2962511060138977,-0.010721445285167497
592826,243,81.0,43,80,123,1.4569696792875324,0.08870251378278904
592831,11,3.6666666666666665,1,8,9,1.4274812186564645,0.07046031910023265
592836,349,116.33333333333333,44,98,142,1.2509989133633665,-0.03871542294549413
592865,16,5.333333333333333,3,5,8,1.3551078531629597,0.025688601794197408
592866,188,62.666666666666664,24,73,97,1.4638057284539523,0.09293144052513569
592879,12,4.0,3,4,7,1.3728958630527812,0.03669264651138726
593140,43,14.333333333333334,5,21,26,1.4593275748786072,0.09016115860496776
593144,142,47.333333333333336,6,35,41,1.0854670322759172,-0.14111699753923934
593334,290,96.66666666666667,25,90,115,1.2336321695639663,-0.04945886341715311
593372,247,82.33333333333333,34,88,122,1.4331794076265376,0.07398534110224775
593423,406,135.33333333333334,39,139,178,1.3202218389091909,0.004107364588305407
593576,151,50.333333333333336,19,44,63,1.2898899152220673,-0.014656614444699567
593619,39,13.0,6,10,16,1.3111547112811333,-0.0015017551779651361
593833,103,34.333333333333336,10,39,49,1.3775925292709668,0.03959810504254102
593958,344,114.66666666666667,36,124,160,1.379729385755429,0.04092001032901671
593974,99,33.0,11,31,42,1.3081543982620591,-0.0033578132098617264
594056,43,14.333333333333334,5,19,24,1.4234146888671653,0.06794467648914793
594311,21,7.0,1,5,6,1.267043776760667,-0.02878972606322938
594577,157,52.333333333333336,20,57,77,1.41178319679939,0.06074918583930977
594580,8,2.6666666666666665,3,1,4,1.3463312283973765,0.020259193333966308
594694,3,1.0,3,6,9,1.517351088261941,0.1260557493924408
594795,39,13.0,5,15,20,1.3847423120495177,0.044021114131286065
594798,274,91.33333333333333,11,41,52,0.8084268510453693,-0.3125
594835,264,88.0,27,85,112,1.2930914936406692,-0.012676049316722948
594965,72,24.0,12,32,44,1.518895299218243,0.12701103143473624
594985,35,11.666666666666666,2,14,16,1.3441250231430828,0.018894387409980395
594986,40,13.333333333333334,5,17,22,1.412871957637421,0.061422716662725474
594987,64,21.333333333333332,8,15,23,1.2485247955355934,-0.04024596533787217
595014,153,51.0,14,36,50,1.1398208453317356,-0.1074925621402999
595191,62,20.666666666666668,8,33,41,1.5521565523939704,0.14758715656410837
595263,10,3.3333333333333335,4,8,12,1.505257061836626,0.1185741250612562
595345,55,18.333333333333332,6,12,18,1.2275092325404062,-0.053246643681787775
595411,40,13.333333333333334,8,16,24,1.4494415025987055,0.0840454220993535
595465,119,39.666666666666664,29,41,70,1.5460969081476421,0.14383853056997653
595798,8,2.6666666666666665,3,2,5,1.369046291697497,0.03431121904434953
595918,23,7.666666666666667,1,6,7,1.270211720158016,-0.02682996828133699
595928,134,44.666666666666664,12,43,55,1.2818616135574932,-0.01962309417274466
596001,103,34.333333333333336,11,39,50,1.3908042588815126,0.04777116455433361
596027,81,27.0,19,20,39,1.3790897459331015,0.040524315405785716
596049,31,10.333333333333334,5,18,23,1.514218132219133,0.12411763553903121
596057,127,42.333333333333336,19,46,65,1.4370887763263125,0.07640376049006925
596071,14,4.666666666666667,3,5,8,1.3747370054004786,0.03783161668569368
596082,25,8.333333333333334,1,7,8,1.2732946585725058,-0.024922796406376513
596112,85,28.333333333333332,14,31,45,1.4387998155926645,0.07746224610574115
596133,119,39.666666666666664,11,36,47,1.262229173780387,-0.031768142806792854
596295,306,102.0,29,87,116,1.1947127431419116,-0.0735352559629392
598264,140,46.666666666666664,12,31,43,1.1164092243271604,-0.1219754933974756
598286,61,20.333333333333332,5,23,28,1.34981337885539,0.022413326347681894
598287,56,18.666666666666668,5,15,20,1.2540126233152182,-0.03685107728343151
600921,45,15.0,1,12,13,1.2113922847912837,-0.06321693349129809
601713,373,124.33333333333333,52,107,159,1.2931981729650535,-0.012610055196908831
605130,168,56.0,21,49,70,1.2867121648936413,-0.01662243900465077
605135,450,150.0,34,131,165,1.1510968190266095,-0.10051700278673503
605138,42,14.0,12,18,30,1.540373221554955,0.14029773519133515
605151,109,36.333333333333336,15,35,50,1.3550004594954737,0.025622165766407967
605154,46,15.333333333333334,1,23,24,1.3983060853411833,0.05241195542043553
605155,2,0.6666666666666666,3,4,7,1.4817945314573928,0.10405970017220545
605164,252,84.0,29,90,119,1.3901931120405802,0.047393096000962864
605177,144,48.0,12,27,39,1.0549865417555142,-0.15997288320412872
605194,23,7.666666666666667,4,13,17,1.4741948990551779,0.09935840445075261
605195,73,24.333333333333332,19,19,38,1.4198502839442435,0.06573965909794177
605200,357,119.0,61,128,189,1.523291406945681,0.12973055803236833
605218,17,5.666666666666667,2,11,13,1.4518314670715502,0.08552390542011701
605240,5,1.6666666666666667,3,3,6,1.4241101062064383,0.06837487658156227
605242,146,48.666666666666664,13,52,65,1.3359868743896937,0.013859953915052015
605276,54,18.0,9,25,34,1.5039580811763729,0.11777054774368512
605280,151,50.333333333333336,24,43,67,1.3335150235061657,0.01233081390304136
605288,306,102.0,48,95,143,1.3830537596922146,0.042976539400207625
605309,34,11.333333333333334,3,11,14,1.3146706865742424,0.0006733026047520685
605347,331,110.33333333333333,50,141,191,1.6235078161311767,0.19172657978544883
605359,81,27.0,8,28,36,1.3352024962790816,0.013374720780045757
605388,44,14.666666666666666,8,12,20,1.3435471409569169,0.01853689708603612
605397,404,134.66666666666666,33,116,149,1.16047141853986,-0.09471767431275091
605400,403,134.33333333333334,30,134,164,1.2480506550307067,-0.04053927883108033
605441,79,26.333333333333332,16,20,36,1.348352604585547,0.02150966003050314
605447,124,41.333333333333336,20,32,52,1.2972548554036767,-0.010100504368314334
605452,323,107.66666666666667,30,106,136,1.2834903372239954,-0.018615530753950282
605483,304,101.33333333333333,62,98,160,1.508654685100807,0.12067596773858702
605488,132,44.0,13,35,48,1.2098648613325664,-0.0641618304272632
605501,0,0.0,2,2,4,1.4331416363655975,0.07396197498951318
605507,160,53.333333333333336,20,41,61,1.2279018477764003,-0.05300376346976354
605513,150,50.0,12,42,54,1.1960816876779772,-0.07268839749009581
605521,42,14.0,6,10,16,1.287469267663536,-0.01615407898084631
605525,78,26.0,12,29,41,1.429256626498042,0.0715586244981371
605538,139,46.333333333333336,9,40,49,1.1890755874899495,-0.07702252144436028
605540,419,139.66666666666666,36,96,132,1.0345080039637737,-0.1726413462305586
606149,178,59.333333333333336,13,43,56,1.1050756269748765,-0.12898669998234036
606160,149,49.666666666666664,16,64,80,1.4861018511255784,0.10672430057064941
606213,3,1.0,2,3,5,1.422915657065801,0.06763596470567546
606303,89,29.666666666666668,9,22,31,1.2146716594204716,-0.06118824195764594
606424,133,44.333333333333336,11,27,38,1.0884592151308112,-0.13926596900140942
606930,81,27.0,11,29,40,1.3937188291511082,0.04957418028103244
606965,22,7.333333333333333,2,12,14,1.4226733263071067,0.06748605369699379
607054,3,1.0,1,3,4,1.399306799266766,0.053031018533984176
607074,331,110.33333333333333,29,82,111,1.0961175273138042,-0.13452837270807272
607179,17,5.666666666666667,5,7,12,1.4305655722148412,0.07236836641357614
607188,77,25.666666666666668,9,32,41,1.4363648468708385,0.07595592219059288
607192,263,87.66666666666667,27,55,82,1.0639166914526426,-0.15444850092600615
607200,270,90.0,32,93,125,1.3723702402750269,0.03636748497917497
607219,72,24.0,7,27,34,1.3658894616461268,0.03235833621681494
607229,78,26.0,7,26,33,1.3104864621357162,-0.001915148442525938
607231,253,84.33333333333333,56,77,133,1.4978911641909738,0.11401742267706305
607237,104,34.666666666666664,21,34,55,1.4504751451261673,0.08468485555279937
607359,70,23.333333333333332,12,19,31,1.3335908561022547,0.012377725574642229
607374,24,8.0,3,8,11,1.3426755508141286,0.01799771271601891
607391,56,18.666666666666668,6,20,26,1.3539732219190705,0.024986694553161937
607455,35,11.666666666666666,5,16,21,1.4384225674515676,0.07722887230845743
607468,11,3.6666666666666665,4,4,8,1.4052706693888875,0.05672039659919925
607481,125,41.666666666666664,23,33,56,1.3402255234983016,0.016482073231406047
607536,227,75.66666666666667,22,91,113,1.437918017159199,0.07691674666800163
607560,68,22.666666666666668,6,10,16,1.1131888734779787,-0.12396767155393773
607572,89,29.666666666666668,22,22,44,1.397709280993189,0.05204275944104153
607625,90,30.0,10,25,35,1.2650536861129,-0.03002083885296425
607644,292,97.33333333333333,17,82,99,1.1123373176107203,-0.12449446229109928
608032,124,41.333333333333336,15,45,60,1.3940013706835606,0.04974896653743921
608328,130,43.333333333333336,17,50,67,1.4437354774462432,0.08051555246671782
608331,323,107.66666666666667,34,113,147,1.3573041244213413,0.02704726233509014
608334,76,25.333333333333332,13,29,42,1.4585388048416557,0.08967320853006022
608335,145,48.333333333333336,23,39,62,1.3075036319130726,-0.00376039124130223
608337,419,139.66666666666666,41,120,161,1.194708066082618,-0.07353814929220603
608344,404,134.66666666666666,25,144,169,1.2740925142406627,-0.024429225764992624
608349,24,8.0,4,5,9,1.3021544358958128,-0.007069518711971257
608371,94,31.333333333333332,14,29,43,1.3519051682330767,0.0237073521545923
608379,251,83.66666666666667,24,107,131,1.489881432517899,0.10906243074434319
608566,418,139.33333333333334,48,118,166,1.224583690393577,-0.0550564468472422
608638,109,36.333333333333336,10,30,40,1.2262842898497446,-0.05400441952222901
608648,133,44.333333333333336,24,41,65,1.4035473254457587,0.05565429904636732
608650,14,4.666666666666667,3,4,7,1.3530090460446578,0.024390234662314603
608652,45,15.0,6,12,18,1.3001124342813704,-0.00833274473990131
608665,119,39.666666666666664,8,24,32,1.0770980426713075,-0.14629423413946852
608678,93,31.0,15,18,33,1.2199294489121315,-0.0579356605256498
608716,136,45.333333333333336,12,35,47,1.1797213199981467,-0.08280927209347322
608717,176,58.666666666666664,26,58,84,1.392374851106164,0.04874276661547383
608718,175,58.333333333333336,15,57,72,1.276657744196664,-0.02284231945447468
608723,126,42.0,15,40,55,1.3228695470629483,0.0057452936822557366
612434,152,50.666666666666664,29,42,71,1.3721517759728452,0.03623233827275829
613534,124,41.333333333333336,25,36,61,1.406094685093546,0.057230150400658375
614179,142,47.333333333333336,19,37,56,1.2545948529596735,-0.03649089752847612
615698,308,102.66666666666667,34,104,138,1.341935263991176,0.01753975539792796
617228,128,42.666666666666664,20,33,53,1.2885707154123538,-0.015472699762107855
620396,10,3.3333333333333335,1,5,6,1.3709997903166213,0.03551969521975984
621052,159,53.0,41,30,71,1.3382201329840058,0.015241495615842315
621056,15,5.0,2,2,4,1.278564965442889,-0.021662471455230925
621057,49,16.333333333333332,8,12,20,1.304732217443767,-0.005474847717265696
621074,35,11.666666666666666,5,16,21,1.4384225674515676,0.07722887230845743
621076,250,83.33333333333333,29,70,99,1.2372285107951515,-0.047234089540178825
621107,316,105.33333333333333,14,119,133,1.28345496192959,-0.018637414670359842
621111,464,154.66666666666666,39,108,147,1.0318674039186049,-0.17427487809596853
621114,64,21.333333333333332,12,11,23,1.2485247955355934,-0.04024596533787217
621121,346,115.33333333333333,55,97,152,1.3228029606171843,0.005704101877703982
621129,34,11.333333333333334,2,19,21,1.4475224214297204,0.08285823729733066
621139,19,6.333333333333333,3,10,13,1.4315362015083177,0.07296881852797155
621219,230,76.66666666666667,22,92,114,1.4342075911845769,0.07462139752003838
621237,122,40.666666666666664,36,37,73,1.5638223213557108,0.15480385163626764
621242,135,45.0,18,41,59,1.3232330539565742,0.005970166848913605
621244,411,137.0,37,124,161,1.212570490720494,-0.06248807001464196
621248,39,13.0,6,11,17,1.3295516114732293,0.009878962149347581
621249,196,65.33333333333333,23,73,96,1.4178457754932179,0.0644996271456495
621259,6,2.0,1,3,4,1.3670327182157813,0.03306557926950171
621261,29,9.666666666666666,2,12,14,1.3576138669278666,0.027238875697896403
621295,134,44.666666666666664,8,42,50,1.223738062755798,-0.055579570254404964
621345,107,35.666666666666664,16,35,51,1.3797114883262847,0.04090893859520017
621348,107,35.666666666666664,13,49,62,1.522524766815364,0.12925629799269822
621366,57,19.0,9,13,22,1.2802232736951054,-0.020636606376714495
621368,181,60.333333333333336,31,52,83,1.3597205644878183,0.02854212402634304
621433,3,1.0,2,2,4,1.399306799266766,0.053031018533984176
621593,62,20.666666666666668,5,23,28,1.342559084859167,0.017925664376470807
622065,134,44.666666666666664,18,55,73,1.491106396443596,0.10982021972123301
622072,343,114.33333333333333,34,117,151,1.324876326303661,0.006986730393788276
622075,96,32.0,22,34,56,1.5168346584100294,0.12573627480147043
622088,101,33.666666666666664,12,20,32,1.1632387228778074,-0.09300576045226494
622092,122,40.666666666666664,23,31,54,1.332181813236134,0.011506061414161772
622098,123,41.0,12,30,42,1.1810827797704835,-0.0819670438561243
622250,120,40.0,20,37,57,1.379972685538144,0.04107052079675666
622251,136,45.333333333333336,19,38,57,1.2950744570784407,-0.01144934557206867
622253,144,48.0,19,47,66,1.357145354034227,0.026949043565796083
622256,12,4.0,4,5,9,1.4169905061734465,0.0639705391870583
622446,67,22.333333333333332,15,24,39,1.4801373222167726,0.10303451496585136
622491,413,137.66666666666666,56,141,197,1.40914574567788,0.05911760196566329
622492,5,1.6666666666666667,2,8,10,1.5170822270162625,0.12588942605506404
622503,170,56.666666666666664,16,68,84,1.4207838085136408,0.06631715743361122
622608,336,112.0,24,141,165,1.4363246458115708,0.07593105295245994
622694,38,12.666666666666666,1,10,11,1.2266926577845323,-0.05375179435261723
622766,114,38.0,17,26,43,1.2383335488841027,-0.046550489259971184
622780,49,16.333333333333332,14,14,28,1.4434036694409205,0.08031028891274472
622786,4,1.3333333333333333,1,6,7,1.4586543185357843,0.08974466778061796
623149,115,38.333333333333336,11,23,34,1.1202165903262291,-0.11962017506968259
623167,375,125.0,26,137,163,1.312060428211992,-0.0009414592443548475
623352,124,41.333333333333336,14,20,34,1.0795751960239381,-0.14476181390625953
623354,13,4.333333333333333,1,5,6,1.3409934369872643,0.016957120998065678
623364,51,17.0,10,10,20,1.2898270351282322,-0.014695513420395545
623454,18,6.0,2,10,12,1.4204961979515105,0.06613923536664468
623470,13,4.333333333333333,3,10,13,1.4941987655285565,0.11173322561136534
623485,48,16.0,8,12,20,1.3123147420587065,-0.0007841352402206958
624133,152,50.666666666666664,18,27,45,1.089615710995272,-0.1385505358367891
624414,3,1.0,1,1,2,1.3520890836686958,0.023821126190601394
624418,8,2.6666666666666665,4,6,10,1.4826216081981,0.10457134759626596
624522,124,41.333333333333336,21,31,52,1.2972548554036767,-0.010100504368314334
624586,20,6.666666666666667,6,8,14,1.4424229471943204,0.07970359308091335
624647,98,32.666666666666664,17,34,51,1.4356278671625864,0.07550001072463919
625643,58,19.333333333333332,5,10,15,1.157852169373635,-0.09633799806617394
626929,43,14.333333333333334,4,13,17,1.2977195878271177,-0.00981301091622222
628317,305,101.66666666666667,30,107,137,1.344326024285839,0.019018731031149705
628345,21,7.0,4,8,12,1.3911209951277126,0.047967104394615157
628452,165,55.0,9,41,50,1.092504260521636,-0.136763617100359
628711,415,138.33333333333334,27,124,151,1.1479217057459161,-0.10248119601235761
640444,236,78.66666666666667,40,89,129,1.5352842106828564,0.13714956383604016
640448,138,46.0,20,44,64,1.3653220409977165,0.03200731762467124
640451,26,8.666666666666666,3,8,11,1.3247816739962353,0.006928176444810918
640455,399,133.0,33,134,167,1.2748007595960422,-0.023991089986476033
640462,22,7.333333333333333,4,2,6,1.2583696100444481,-0.03415575177497865
640464,40,13.333333333333334,6,19,25,1.4677262750793478,0.09535677481766758
640470,318,106.0,31,101,132,1.2708621645110787,-0.02642758944348622
641154,301,100.33333333333333,24,92,116,1.2087658411226725,-0.064841707918319
641302,195,65.0,14,73,87,1.3376687672543275,0.014900408941026733
641312,56,18.666666666666668,10,32,42,1.6205348181960102,0.1898874194507445
641360,107,35.666666666666664,9,28,37,1.197949133885638,-0.07153315518343362
641386,84,28.0,16,36,52,1.5466418750683588,0.14417565880422534
641394,158,52.666666666666664,31,38,69,1.321693156848135,0.005017553445497813
641401,133,44.333333333333336,14,39,53,1.263508165305782,-0.030976931197088997
641420,25,8.333333333333334,4,15,19,1.4946657566722938,0.11202211635631365
641447,52,17.333333333333332,7,21,28,1.4188101121459795,0.06509618649743432
641482,146,48.666666666666664,14,41,55,1.224904953331714,-0.05485770669816803
641540,296,98.66666666666667,35,106,141,1.4016947478114552,0.054508254758321106
641541,41,13.666666666666666,8,21,29,1.53153080092127,0.13482762399486292
641576,0,0.0,2,1,3,1.4089619231557704,0.05900388540794543
641582,99,33.0,11,38,49,1.4022948497905587,0.05487949072309917
641632,17,5.666666666666667,1,10,11,1.409299677358132,0.05921282740703515
641645,3,1.0,1,3,4,1.399306799266766,0.053031018533984176
641672,11,3.6666666666666665,1,7,8,1.4052706693888875,0.05672039659919925
641682,96,32.0,14,34,48,1.407778920027008,0.05827205428068005
641703,13,4.333333333333333,3,5,8,1.384766387999062,0.044036008030436946
641726,15,5.0,3,3,6,1.3217084111429833,0.005026990079706972
641729,100,33.333333333333336,26,32,58,1.516534134698681,0.12555036438323153
641743,99,33.0,18,41,59,1.5367812091169866,0.13807563919875732
641745,366,122.0,58,155,213,1.6422341381599252,0.20331108453157887
641755,142,47.333333333333336,20,47,67,1.3786219214610949,0.04023490914608363
641771,204,68.0,35,64,99,1.4107047402976303,0.06008202949948238
641778,217,72.33333333333333,26,64,90,1.277772980610723,-0.022152410271460088
641793,122,40.666666666666664,17,30,47,1.2468405734026058,-0.041287861299245665
641816,391,130.33333333333334,45,117,162,1.265478560549748,-0.029758002406884754
641835,107,35.666666666666664,10,30,40,1.2368982098372052,-0.047438420802297765
641851,78,26.0,11,21,32,1.2956401915904254,-0.01109937006010886
641871,89,29.666666666666668,16,27,43,1.3836294639491338,0.04333268241037325
641907,28,9.333333333333334,4,14,18,1.445451904539732,0.08157737110790009
641927,172,57.333333333333336,16,60,76,1.3301245676305018,0.010233405126086836
641941,146,48.666666666666664,13,41,54,1.2137967612259162,-0.06172947275948992
641995,1,0.3333333333333333,2,1,3,1.3976966219976874,0.05203492831471335
642003,28,9.333333333333334,6,9,15,1.3862690035828407,0.04496555828249227
642048,54,18.0,5,14,19,1.2512498214540777,-0.038560205815124204
642068,58,19.333333333333332,8,13,21,1.2567147279184159,-0.03517949737829973
642073,45,15.0,4,14,18,1.3001124342813704,-0.00833274473990131
642083,82,27.333333333333332,14,36,50,1.5325364601942377,0.13544974640645013
642092,200,66.66666666666667,13,90,103,1.4651459635411286,0.09376053871668066
642121,131,43.666666666666664,19,33,52,1.2616538433278401,-0.03212405457355039
642130,92,30.666666666666668,15,28,43,1.3644186983055044,0.03144849044604825
642152,162,54.0,24,38,62,1.2298041601347713,-0.05182695221390987
642203,139,46.333333333333336,20,50,70,1.4285547085703814,0.07112440300221845
642207,126,42.0,23,33,56,1.3348661424067063,0.01316664505514209
642232,354,118.0,20,130,150,1.2881168462053263,-0.015753472995360007
642233,56,18.666666666666668,8,27,35,1.5039141198248491,0.11774335230805222
642397,145,48.333333333333336,27,37,64,1.3298025831359825,0.010034218606747247
642528,177,59.0,13,52,65,1.1984259670964872,-0.07123817592452131
642545,86,28.666666666666668,11,29,40,1.3605462551697325,0.029052914004684016
642547,357,119.0,50,64,114,1.0555849287622439,-0.1596027081580711
642701,104,34.666666666666664,21,40,61,1.529397953853107,0.13350819901936728
643230,44,14.666666666666666,2,12,14,1.2364495137356726,-0.04771599384145597
643256,155,51.666666666666664,10,47,57,1.2069018449051643,-0.06599481598702261
643290,149,49.666666666666664,29,41,70,1.3762402933563416,0.03876158288155207
643316,133,44.333333333333336,29,38,67,1.426887185469088,0.07009283742027672
643327,10,3.3333333333333335,5,5,10,1.4605046379966247,0.09088931511409082
643338,181,60.333333333333336,11,41,52,1.0548734466053498,-0.1600428462914788
643377,132,44.0,15,41,56,1.3035888856941211,-0.006182137277908728
643400,24,8.0,4,8,12,1.3629361082732867,0.03053132843001405
643511,170,56.666666666666664,9,54,63,1.2065497949205857,-0.06621260166383436
643615,47,15.666666666666666,9,21,30,1.4953517489631423,0.11244648591147466
643778,50,16.666666666666668,18,22,40,1.6419238489283319,0.20311913295291073
645261,429,143.0,41,130,171,1.227349301938307,-0.05334558018497437
647315,128,42.666666666666664,17,47,64,1.4194862371678783,0.06551445194823335
649144,56,18.666666666666668,9,28,37,1.5372343193594666,0.1383559429202501
650347,12,4.0,1,6,7,1.3728958630527812,0.03669264651138726
650382,100,33.333333333333336,26,28,54,1.4629796691380736,0.09242042250191196
650496,144,48.0,23,58,81,1.5250113608557343,0.1307945584379765
650530,96,32.0,19,38,57,1.530466625707907,0.1341693023665691
650556,106,35.333333333333336,17,32,49,1.3596294723122484,0.02848577245134587
650633,146,48.666666666666664,20,50,70,1.3915278349186837,0.04821878422166204
650644,290,96.66666666666667,23,84,107,1.1756710883221093,-0.08531483234187387
650671,30,10.0,6,9,15,1.3682738007315947,0.03383333955220469
650828,108,36.0,6,32,38,1.2057142197892208,-0.06672950637476405
650893,157,52.333333333333336,28,41,69,1.3263955039055055,0.007926526265704115
650895,129,43.0,12,30,42,1.1530807642665197,-0.09928969167820456
650911,23,7.666666666666667,5,13,18,1.494593216944894,0.11197724172396162
655889,18,6.0,2,8,10,1.3782637783033531,0.04001335410157014
656061,72,24.0,11,17,28,1.274085959102857,-0.024433280913937816
656212,55,18.333333333333332,5,20,25,1.344781185054498,0.01930030325214893
656232,115,38.333333333333336,11,41,52,1.346090958977747,0.02011055751387436
656266,51,17.0,6,24,30,1.461186132224074,0.09131090207068737
656288,182,60.666666666666664,28,66,94,1.463096201368994,0.0924925118411909
656302,376,125.33333333333333,49,116,165,1.3214349770982965,0.004857837910713814
656322,85,28.333333333333332,9,27,36,1.3096570535805756,-0.0024282383770446447
656353,60,20.0,8,15,23,1.2756561770459849,-0.023461910391381458
656354,46,15.333333333333334,6,16,22,1.363026691750037,0.03058736531300288
656420,126,42.0,26,25,51,1.274883165687917,-0.023940111809289566
656427,201,67.0,19,52,71,1.1653186617688238,-0.09171906561076593
656457,38,12.666666666666666,5,2,7,1.1526510114234265,-0.09955554601109673
656458,73,24.333333333333332,15,22,37,1.4046273401624865,0.05632241933141935
656464,85,28.333333333333332,14,32,46,1.4531490113717855,0.08633896660382845
656529,146,48.666666666666664,27,72,99,1.7136654059868248,0.24750000000000005
656546,170,56.666666666666664,33,56,89,1.4717919069881777,0.09787186198062203
656548,108,36.0,26,23,49,1.347912112000092,0.021237161862469822
656557,92,30.666666666666668,6,28,34,1.239459744121929,-0.04585380071335543
656578,11,3.6666666666666665,4,2,6,1.3608495708537331,0.029240551597132125
656605,184,61.333333333333336,33,84,117,1.6775721443190554,0.22517193363161825
656620,26,8.666666666666666,1,10,11,1.3247816739962353,0.006928176444810918
656629,145,48.333333333333336,19,31,50,1.173709924575613,-0.08652805032959965
656638,51,17.0,10,24,34,1.5297297710624107,0.1337134682671205
656685,143,47.666666666666664,8,51,59,1.283596154424517,-0.018550069962462223
656686,49,16.333333333333332,14,24,38,1.6167429844373624,0.18754170970025785
656725,6,2.0,1,3,4,1.3670327182157813,0.03306557926950171
656730,30,10.0,5,19,24,1.5435177381376473,0.1422430006428509
656731,150,50.0,13,47,60,1.26175811186386,-0.0320595518191632
656756,342,114.0,35,103,138,1.2440407289856528,-0.04301990515104015
656793,43,14.333333333333334,16,18,34,1.6029791189243758,0.17902708706824788
656794,75,25.0,21,26,47,1.5412155528357965,0.140818819401344
656803,11,3.6666666666666665,3,6,9,1.4274812186564645,0.07046031910023265
656849,197,65.66666666666667,29,69,98,1.4321172448298864,0.07332826439812623
656876,130,43.333333333333336,19,36,55,1.3020427733664923,-0.007138595549317839
656887,63,21.0,7,22,29,1.3514190436661846,0.023406625063403408
656945,128,42.666666666666664,31,36,67,1.4551904703739305,0.08760185696014466
656954,222,74.0,34,101,135,1.6494052569483393,0.20774729253397828
656970,14,4.666666666666667,1,3,4,1.2878251679771955,-0.015933911407822188
656981,9,3.0,2,3,5,1.3587581988652364,0.027946783996133373
657006,68,22.666666666666668,9,19,28,1.3006196115056765,-0.008018994022964798
657024,69,23.0,8,16,24,1.231729809185711,-0.05063570437913789
657031,114,38.0,18,38,56,1.4021502595043829,0.054790044068605104
657044,101,33.666666666666664,7,28,35,1.203226113437381,-0.06826870236837745
657053,101,33.666666666666664,11,30,41,1.2832008945565283,-0.01879458620060226
657093,107,35.666666666666664,14,39,53,1.4056775389606626,0.056972094849290666
657097,64,21.333333333333332,6,27,33,1.4080390635565772,0.058432984651755726
657140,19,6.333333333333333,5,11,16,1.4944420532589773,0.11188372862329732
657141,19,6.333333333333333,2,12,14,1.4525048187585377,0.08594045522641358
657228,22,7.333333333333333,3,14,17,1.4842872199056036,0.10560173074898338
657240,13,4.333333333333333,1,1,2,1.2534475349636687,-0.03720065306667708
657277,253,84.33333333333333,26,76,102,1.2512532307080575,-0.03855809677743649
657610,7,2.3333333333333335,3,4,7,1.4252681033602284,0.06909123847598508
657612,133,44.333333333333336,15,40,55,1.2868480253291115,-0.016538392823179593
657697,3,1.0,2,1,3,1.3756979414677308,0.038426072362292674
658305,29,9.666666666666666,3,12,15,1.3772126215630025,0.039363085980108625
658551,52,17.333333333333332,12,22,34,1.5210416270670972,0.128338795910517
659275,102,34.0,11,38,49,1.3836861584011841,0.04336775481529331
660271,275,91.66666666666667,39,68,107,1.2198613915855434,-0.057977762248650144
660365,86,28.666666666666668,15,30,45,1.4319507019366182,0.07322523738969722
660422,3,1.0,2,2,4,1.399306799266766,0.053031018533984176
660546,64,21.333333333333332,11,20,31,1.3761362099523804,0.03869719465383015
660600,25,8.333333333333334,17,9,26,1.635538273644886,0.19916887902348002
660623,134,44.666666666666664,11,37,48,1.20048864243512,-0.06996216068706917
660761,182,60.666666666666664,22,54,76,1.286666520873882,-0.01665067537497078
660813,46,15.333333333333334,3,16,19,1.3101076013633175,-0.002149519848146153
660825,9,3.0,2,1,3,1.3136694700414466,5.3928567593564125e-05
660853,63,21.0,6,30,36,1.4636759170471294,0.09285113640262121
660896,131,43.666666666666664,10,39,49,1.2263695430832695,-0.05395168004210704
660906,4,1.3333333333333333,3,3,6,1.4352298027574235,0.07525375953960689
661255,37,12.333333333333334,4,18,22,1.439187167553191,0.0777018703425909
661269,236,78.66666666666667,33,76,109,1.368650384982879,0.0340663026530007
661403,149,49.666666666666664,12,40,52,1.1784894893717153,-0.08357130895882325
661440,20,6.666666666666667,4,11,15,1.4632460207580302,0.09258519333095094
661563,34,11.333333333333334,3,6,9,1.2197765902489008,-0.05803022217566123
663366,32,10.666666666666666,10,16,26,1.5621820988977995,0.15378917481829923
663378,11,3.6666666666666665,3,7,10,1.4496917679240418,0.08420024160126627
663399,28,9.333333333333334,9,14,23,1.544090072801218,0.14259705915024645
663423,122,40.666666666666664,13,47,60,1.4053314473791583,0.05675799516851099
663432,78,26.0,20,29,49,1.548026790860368,0.14503239743880025
663460,258,86.0,44,94,138,1.517548623544622,0.1261779489581768
663465,284,94.66666666666667,18,96,114,1.2444190021290624,-0.042785897265325334
663474,249,83.0,46,58,104,1.2807516757330881,-0.02030972553447119
663531,67,22.333333333333332,11,32,43,1.5429412176837383,0.1418863527157087
663554,359,119.66666666666667,32,116,148,1.2623637260498706,-0.031684905884879266
663556,267,89.0,30,86,116,1.3138568445555059,0.0001698424637709417
663559,59,19.666666666666668,2,19,21,1.2498500957924445,-0.03942610615292552
663574,71,23.666666666666668,11,29,40,1.4651655938181964,0.09377268242741632
663734,92,30.666666666666668,20,31,51,1.4754933242464603,0.10016163814329593
663738,95,31.666666666666668,13,39,52,1.468981826625765,0.09613348595326332
663753,39,13.0,8,11,19,1.3663454118574216,0.03264039680397324
663765,118,39.333333333333336,17,50,67,1.5153046834820016,0.12478979947182545
663770,54,18.0,9,17,26,1.3691803426578155,0.03439414584565348
663776,259,86.33333333333333,36,73,109,1.2864751147983253,-0.016769083281623187
663804,15,5.0,5,12,17,1.558997362493502,0.1518190285218659
663855,29,9.666666666666666,10,5,15,1.3772126215630025,0.039363085980108625
663878,7,2.3333333333333335,5,4,9,1.471044837095291,0.09740970850987918
663903,271,90.33333333333333,39,118,157,1.6118908368855844,0.18454006707891435
663959,13,4.333333333333333,1,6,7,1.362879912493163,0.0304965645142512
663978,280,93.33333333333333,19,104,123,1.3235577671688072,0.0061710414115997425
663986,126,42.0,22,46,68,1.4788252865318006,0.10222286152977789
663992,47,15.666666666666666,5,14,19,1.3024493309335625,-0.006887090312033606
664042,84,28.0,17,24,41,1.388042128560307,0.04606245145165855
664045,64,21.333333333333332,10,30,40,1.5196990511712658,0.12750824964449525
664054,47,15.666666666666666,10,17,27,1.4427419985914387,0.07990096512324507
664062,106,35.333333333333336,26,26,52,1.3987478398491817,0.05268523424084004
664074,62,20.666666666666668,6,35,41,1.5521565523939704,0.14758715656410837
664076,55,18.333333333333332,12,21,33,1.4788062736420313,0.10221109974807674
664092,37,12.333333333333334,5,18,23,1.4578124999999995,0.08922390076570663
664126,94,31.333333333333332,14,27,41,1.3243911871773306,0.006686612917282342
664129,27,9.0,11,13,24,1.574169251218431,0.16120468453439596
664141,334,111.33333333333333,31,116,147,1.32471016631646,0.006883940259271193
664157,32,10.666666666666666,8,7,15,1.3507398035767892,0.022986432564989556
664192,115,38.333333333333336,11,36,47,1.2833480787967697,-0.01870353487044707
664199,110,36.666666666666664,8,40,48,1.3235783610045124,0.006183781200390204
664208,141,47.0,22,48,70,1.417776049452547,0.06445649312030055
664285,251,83.66666666666667,40,76,116,1.3699041323729912,0.03484189769878199
664299,253,84.33333333333333,43,56,99,1.2273850435968074,-0.053323469627872044
664337,28,9.333333333333334,3,5,8,1.2481755680167606,-0.04046200497679264
664353,228,76.0,13,62,75,1.1100354756898367,-0.12591843110976964
664682,11,3.6666666666666665,1,6,7,1.3830601201213102,0.04298047409816563
664714,43,14.333333333333334,3,20,23,1.4054582458614442,0.05683643543123784
664776,50,16.666666666666668,7,10,17,1.2455337573347889,-0.04209628576811375
664852,8,2.6666666666666665,3,3,6,1.3917613549976176,0.04836324475473275
664854,143,47.666666666666664,25,40,65,1.3509939749977442,0.023143668461491962
664875,49,16.333333333333332,16,19,35,1.5647411899384298,0.1553722834640039
664918,48,16.0,12,18,30,1.4866614282268915,0.10707046697620604
664948,132,44.0,8,46,54,1.2801578796037325,-0.02067706056524732
665152,149,49.666666666666664,24,57,81,1.497088006902502,0.11352057233955926
665620,25,8.333333333333334,4,9,13,1.3739178849815004,0.037324891213028066
665621,10,3.3333333333333335,2,1,3,1.303871154556619,-0.00600751970098834
665661,10,3.3333333333333335,1,4,5,1.3486235783966205,0.02167729024617704
665733,34,11.333333333333334,5,9,14,1.3146706865742424,0.0006733026047520685
665854,68,22.666666666666668,18,30,48,1.6130041748851727,0.1852288018619901
666120,289,96.33333333333333,38,82,120,1.2729320335489556,-0.025147124029277323
666129,100,33.333333333333336,20,44,64,1.5968658330395917,0.17524527720521066
666159,146,48.666666666666664,13,63,76,1.4581769875534714,0.08944938058959395
666168,27,9.0,3,11,14,1.3755870624723079,0.03835748023583285
666200,157,52.333333333333336,27,65,92,1.5718851209754234,0.15979167253982063
666201,176,58.666666666666664,21,44,65,1.2024197757781514,-0.06876752015149512
666205,109,36.333333333333336,19,28,47,1.316385608601755,0.001734190179816908
666619,6,2.0,2,5,7,1.4362257237837444,0.07586985766279808
666808,38,12.666666666666666,4,13,17,1.337755127326191,0.014953833135101902
667297,63,21.0,10,15,25,1.287272258877073,-0.016275952844721275
667373,6,2.0,1,1,2,1.3209040478371392,0.004529393673970872
667376,59,19.666666666666668,5,19,24,1.2990113634701723,-0.009013890776937594
667463,138,46.0,11,45,56,1.2737437872573005,-0.02464495576192749
667465,12,4.0,1,7,8,1.3949431846131137,0.05033159284922273
667498,66,22.0,10,28,38,1.472141030968496,0.09808783756839501
668670,3,1.0,1,2,3,1.3756979414677308,0.038426072362292674
668676,291,97.0,18,92,110,1.1945216701391352,-0.07365345782362076
668678,220,73.33333333333333,33,74,107,1.414857151750246,0.06265080035084669
668687,59,19.666666666666668,14,15,29,1.3809468095997188,0.041673134849708915
668820,60,20.0,7,28,35,1.4712329364877343,0.09752607083138343
668941,27,9.0,3,13,16,1.4153035002215326,0.06292692109554554
669060,138,46.0,9,57,66,1.3882166044328204,0.04617038597132084
669135,24,8.0,7,16,23,1.5858022403240237,0.16840110128396002
669145,176,58.666666666666664,20,70,90,1.4523606643676417,0.08585127822609573
669160,69,23.0,5,17,22,1.200653150654537,-0.0698603923715565
669203,364,121.33333333333333,21,96,117,1.0588854847513225,-0.15756091338055678
669211,174,58.0,23,83,106,1.6231412159400695,0.1914997930385749
669212,145,48.333333333333336,10,55,65,1.3409520587474375,0.016931523530772097
669214,42,14.0,3,16,19,1.34166297206884,0.017371309770335297
669294,50,16.666666666666668,7,28,35,1.5557520898862573,0.1498114332309488
669302,231,77.0,17,75,92,1.2442900338563854,-0.04286567980696021
669330,134,44.666666666666664,10,33,43,1.1423650916334247,-0.1059186367687297
669373,347,115.66666666666667,41,115,156,1.3454687544403081,0.019725648432103893
669424,23,7.666666666666667,4,15,19,1.5149915348346104,0.12459607899717062
669432,327,109.0,39,88,127,1.212251075827274,-0.06268566692346433
669456,271,90.33333333333333,33,84,117,1.3081479272697698,-0.0033618163045843197
669459,29,9.666666666666666,8,12,20,1.4752063947386829,0.09998413739117007
669618,44,14.666666666666666,7,5,12,1.2007503046619246,-0.06980029081728667
669622,127,42.333333333333336,10,34,44,1.186163689682751,-0.07882388392845885
669674,85,28.333333333333332,10,28,38,1.3383554451388175,0.015325202619129952
669735,90,30.0,15,32,47,1.4332222298653623,0.07401183185831517
669912,18,6.0,2,5,7,1.314915148831117,0.0008245322039582836
669952,83,27.666666666666668,12,25,37,1.3367941971270085,0.014359381088616785
670050,15,5.0,2,4,6,1.3217084111429833,0.005026990079706972
670056,54,18.0,9,16,25,1.3523331253429958,0.023972095608399524
670090,31,10.333333333333334,6,15,21,1.4755261658523104,0.10018195466558244
670280,138,46.0,15,33,48,1.1821655335168846,-0.08129722914852622
670456,33,11.0,4,10,14,1.3230406027341217,0.005851112391958457
670550,22,7.333333333333333,4,7,11,1.3610594327086096,0.02937037664500408
670766,27,9.0,4,9,13,1.3557288435976957,0.026072759805976675
670912,190,63.333333333333336,35,67,102,1.5022441403003266,0.11671026712997656
670950,138,46.0,16,32,48,1.1821655335168846,-0.08129722914852622
670955,59,19.666666666666668,11,19,30,1.397333898825628,0.05181053997503815
670970,14,4.666666666666667,2,5,7,1.3530090460446578,0.024390234662314603
670990,37,12.333333333333334,5,7,12,1.252933843085106,-0.03751843388856624
671790,19,6.333333333333333,2,4,6,1.2847558807567785,-0.017832638361122033
672282,47,15.666666666666666,5,18,23,1.3725956647625006,0.03650693740560573
672335,67,22.333333333333332,19,21,40,1.4958382960835142,0.11274747440331578
672578,155,51.666666666666664,24,48,72,1.3681511613404582,0.033757472192533
672715,138,46.0,18,42,60,1.3195329141275085,0.00368118093137193
674944,17,5.666666666666667,5,8,13,1.4518314670715502,0.08552390542011701
675912,25,8.333333333333334,4,15,19,1.4946657566722938,0.11202211635631365
675916,155,51.666666666666664,29,33,62,1.2606516170502624,-0.032744053260504
675921,101,33.666666666666664,19,33,52,1.4298213266082984,0.07190796010698564
676051,140,46.666666666666664,13,54,67,1.3890632208089788,0.04669412103326753
676103,1,0.3333333333333333,2,1,3,1.3976966219976874,0.05203492831471335
676220,32,10.666666666666666,7,14,21,1.4660719646609766,0.09433338288497661
676265,37,12.333333333333334,9,16,25,1.4950631648936166,0.11226796161193808
676424,30,10.0,3,19,22,1.504574640936302,0.1181519648449294
676477,169,56.333333333333336,12,53,65,1.2311395735506383,-0.05100083681172862
676596,288,96.0,25,101,126,1.3197029403834095,0.0037863628226919577
676604,52,17.333333333333332,14,15,29,1.435848697966166,0.0756366213996148
676606,36,12.0,6,14,20,1.410694722052637,0.060075831998099294
676684,104,34.666666666666664,18,41,59,1.5030903509441271,0.11723375119717805
676709,24,8.0,5,11,16,1.4439783381099183,0.08066579128599438
676755,9,3.0,4,3,7,1.4038469276890262,0.05583963942467318
676831,32,10.666666666666666,7,7,14,1.3315177767294246,0.01109527417832501
676840,233,77.66666666666667,20,100,120,1.4725679708471422,0.09835195174110312
676879,21,7.0,3,9,12,1.3911209951277126,0.047967104394615157
676886,28,9.333333333333334,7,9,16,1.4059966372351378,0.05716949589096154
676969,122,40.666666666666664,19,52,71,1.5394391099747027,0.1397198737181512
676979,117,39.0,19,32,51,1.3224788982674365,0.005503629952521183
677651,334,111.33333333333333,34,93,127,1.19372609073029,-0.07414562032213712
677865,14,4.666666666666667,3,3,6,1.3312810866888372,0.010948852638935747
677960,227,75.66666666666667,25,84,109,1.4037368922783602,0.05577156915785053
677976,131,43.666666666666664,12,61,73,1.5086439450398346,0.12066932370634642
680686,72,24.0,7,20,27,1.2587853753456455,-0.03389855043572987
680704,101,33.666666666666664,17,25,42,1.296530024743053,-0.010548900172639653
681806,16,5.333333333333333,3,6,9,1.3765255703267607,0.03893806133859812
681810,29,9.666666666666666,2,8,10,1.2792188483873221,-0.02125796543095293
681911,80,26.666666666666668,13,10,23,1.1506353277661518,-0.10080249118583784
683232,31,10.333333333333334,4,9,13,1.32075830038502,0.004439231171787128
685503,87,29.0,12,34,46,1.4393797171307157,0.07782098564410478
