pitcher,outs,innings,walks,hits,runners,whip,runs
424144,280,93.33333333333333,17,81,98,1.2072711357293033,-0.11969603064385947
425794,1054,351.3333333333333,108,358,466,1.323191848070303,-0.003809678975793096
425844,1741,580.3333333333334,102,528,630,1.1292076453738318,-0.19773638178627784
429722,172,57.333333333333336,20,68,88,1.3801022795925852,0.0530838834237537
431148,15,5.0,1,5,6,1.310914080477644,-0.016083807250265814
433589,677,225.66666666666666,34,179,213,1.0835991005889876,-0.24333140750055504
445213,469,156.33333333333334,37,168,205,1.3130158658664306,-0.01398264486282974
445276,581,193.66666666666666,57,144,201,1.1523236344632233,-0.17462724462976853
446321,338,112.66666666666667,40,130,170,1.4027353443997148,0.07571023944414779
446372,920,306.6666666666667,75,281,356,1.208284413940509,-0.11868305278382074
448179,894,298.0,104,250,354,1.2277922705252928,-0.09918097862623387
448281,423,141.0,29,120,149,1.1836607779450221,-0.14329938995681246
448855,837,279.0,117,250,367,1.3152715222330076,-0.01172765710731527
450203,1380,460.0,155,421,576,1.2665287676859591,-0.060455963556064196
451584,388,129.33333333333334,66,128,194,1.4050736548302076,0.07804785676364867
452657,1330,443.3333333333333,141,494,635,1.4047404518749493,0.07771475257484495
453178,643,214.33333333333334,60,226,286,1.3268348839394803,-0.00016772295819267313
453192,343,114.33333333333333,53,117,170,1.3934065211675009,0.0663841814178876
453265,465,155.0,31,143,174,1.2125980837609878,-0.11437066160108356
453268,133,44.333333333333336,18,50,68,1.3687038219465493,0.04168880445498102
453281,929,309.6666666666667,78,340,418,1.3391871556605293,0.012180887360506265
453286,1675,558.3333333333334,128,451,579,1.09154989706566,-0.2353829677616197
453343,465,155.0,40,168,208,1.3293257719441807,0.002322426709188141
453562,1192,397.3333333333333,140,434,574,1.4115208041963447,0.08449309509606073
455119,363,121.0,10,115,125,1.1823906083244409,-0.14456918307968225
456034,968,322.6666666666667,97,309,406,1.275106343517982,-0.051880930248770385
456501,506,168.66666666666666,54,168,222,1.3156594351531885,-0.011339859170459654
456713,76,25.333333333333332,15,29,44,1.381112572249918,0.05409387661488352
457918,1315,438.3333333333333,133,412,545,1.26033579136897,-0.06664710418010933
458676,184,61.333333333333336,26,71,97,1.3977106937114958,0.07068707813927899
458677,377,125.66666666666667,64,113,177,1.3598421796317819,0.03282978886659471
458681,1501,500.3333333333333,173,480,653,1.307239235861313,-0.019757562586420807
458708,651,217.0,29,256,285,1.3139887706819053,-0.013010028431229337
459429,402,134.0,33,145,178,1.3216145542319482,-0.0053865052801189695
461872,252,84.0,39,88,127,1.390077357817928,0.06305600488327379
465657,497,165.66666666666666,48,143,191,1.2260629494505666,-0.10090978710373188
467008,319,106.33333333333333,44,85,129,1.270357996523252,-0.056627869760792704
468504,981,327.0,130,321,451,1.3603136935087357,0.03330116297962027
474463,997,332.3333333333333,81,368,449,1.3405637625419244,0.013557086194557089
475054,342,114.0,49,108,157,1.3433197367872525,0.0163122435269476
475479,196,65.33333333333333,25,61,86,1.3154187469867722,-0.01158047599322054
476454,257,85.66666666666667,37,67,104,1.2760083927572896,-0.05097914839066009
476595,72,24.0,3,21,24,1.2678174348924,-0.05916767833030212
477132,1502,500.6666666666667,98,423,521,1.0993151836451065,-0.2276199829319383
488748,273,91.0,42,82,124,1.334063836470391,0.007059086800571768
488984,305,101.66666666666667,23,100,123,1.2700568205421738,-0.056928956468701664
489119,969,323.0,112,312,424,1.313372998127561,-0.013625618461166056
489265,500,166.66666666666666,49,160,209,1.2814329141734309,-0.04555623488567151
489334,648,216.0,36,205,241,1.1928167795540114,-0.13414610232680335
491624,99,33.0,8,34,42,1.3067457794272237,-0.020250872752472393
493603,576,192.0,98,142,240,1.2769764014513443,-0.050011426629194666
500610,91,30.333333333333332,11,30,41,1.3216588221334513,-0.00534225050029935
500779,1154,384.6666666666667,140,407,547,1.3940126729191469,0.06699015349687931
501381,648,216.0,46,204,250,1.218364913210548,-0.10860554152801494
501593,271,90.33333333333333,37,99,136,1.3909430615330944,0.06392145199061217
501625,435,145.0,46,148,194,1.3268131447626348,-0.00018945569121342487
501789,451,150.33333333333334,41,129,170,1.2183857172418562,-0.10858474366334003
501925,281,93.66666666666667,23,91,114,1.2751035283216248,-0.05188374461066014
501985,1413,471.0,145,442,587,1.2617009540172723,-0.0652823461869052
502042,811,270.3333333333333,100,286,386,1.390033709868241,0.06301236987150682
502043,1443,481.0,184,487,671,1.377342846467271,0.050325268236642184
502171,749,249.66666666666666,70,286,356,1.3867362358103714,0.0597158732354055
502179,62,20.666666666666668,4,18,22,1.282001308639472,-0.04498800890044774
502202,353,117.66666666666667,57,105,162,1.3436130873862004,0.016605507172289258
502239,808,269.3333333333333,104,273,377,1.371271907556712,0.0442561288452723
502624,1081,360.3333333333333,131,362,493,1.3535804566052516,0.026569921910585048
502706,918,306.0,126,307,433,1.384205069625087,0.05718545732650959
503285,156,52.0,10,46,56,1.2492336321025768,-0.07774597259661298
503569,123,41.0,25,28,53,1.3098259091753937,-0.0171716560018913
506433,1080,360.0,105,304,409,1.185229036901958,-0.14173159585582873
517008,511,170.33333333333334,57,140,197,1.226970856258598,-0.1000021494131711
518397,327,109.0,41,95,136,1.2850857946302248,-0.041904437198540645
518516,1304,434.6666666666667,108,432,540,1.259672382168865,-0.06731031673557597
518553,532,177.33333333333334,72,155,227,1.2952442989898152,-0.031748943975085764
518617,476,158.66666666666666,86,142,228,1.3806096173646565,0.05359107081314618
518633,1147,382.3333333333333,149,388,537,1.3810022999021596,0.053983636953536474
518774,822,274.0,85,330,415,1.4482949701049248,0.12125636057915457
518813,387,129.0,72,111,183,1.3653729909660763,0.038358960783778207
518858,217,72.33333333333333,32,80,112,1.3959139513212153,0.06889086833093638
518876,813,271.0,72,274,346,1.2895449335940141,-0.03744661999177312
518886,392,130.66666666666666,70,89,159,1.2669413683931197,-0.06004348515006663
519043,388,129.33333333333334,51,160,211,1.469077376337418,0.1420326065884323
519076,121,40.333333333333336,27,39,66,1.3883789481539541,0.06135809865391306
519141,633,211.0,103,218,321,1.4403548443207523,0.11331858836976272
519151,537,179.0,47,151,198,1.1964143259748006,-0.13054962227382227
519293,459,153.0,42,111,153,1.1483867783405355,-0.17856293380806076
519326,288,96.0,37,100,137,1.3613144984928203,0.03430167130979345
519443,417,139.0,78,115,193,1.352100032317398,0.025089936443143612
519455,756,252.0,53,313,366,1.4041575501625776,0.07713202364346006
521230,470,156.66666666666666,31,119,150,1.1237719069676775,-0.203170508956392
523260,438,146.0,65,146,211,1.382337434949663,0.05531837624658187
527048,1085,361.6666666666667,146,417,563,1.4905343676454703,0.1634832377159301
527054,1154,384.6666666666667,180,340,520,1.3421835749607074,0.015176418476153142
533167,415,138.33333333333334,47,124,171,1.2752687655980046,-0.05171855631313749
534910,77,25.666666666666668,17,18,35,1.3226946266166628,-0.004306753045386191
541650,25,8.333333333333334,3,11,14,1.3360181366629473,0.009012807708646875
542585,260,86.66666666666667,34,85,119,1.3375667214314058,0.01056093345288378
542881,942,314.0,112,318,430,1.3529494983249046,0.025939150655927223
542882,613,204.33333333333334,61,219,280,1.348174123337365,0.021165191162605623
542888,320,106.66666666666667,43,119,162,1.4044493771459716,0.07742376412487073
542914,320,106.66666666666667,30,83,113,1.202755883263752,-0.12420994471948865
542947,372,124.0,12,137,149,1.2609718480134537,-0.06601123607254777
542960,401,133.66666666666666,72,147,219,1.47513050129586,0.14808393730801273
543022,656,218.66666666666666,154,203,357,1.5106683520254487,0.18361125407485201
543037,1811,603.6666666666666,151,431,582,1.028729379354567,-0.29818486450999604
543101,1120,373.3333333333333,107,369,476,1.2856921182027143,-0.04129829334963575
543135,925,308.3333333333333,78,314,392,1.2847249497921291,-0.042265175076704686
543243,1203,401.0,168,357,525,1.3106870541098556,-0.016310766323964998
543272,515,171.66666666666666,49,155,204,1.244389796777255,-0.08258837213502468
543294,1523,507.6666666666667,88,519,607,1.2209172621991784,-0.10605394909468036
543339,507,169.0,62,141,203,1.251984141260785,-0.0749962787314069
543475,1023,341.0,120,353,473,1.3665063512518416,0.03949198512421237
543507,396,132.0,41,106,147,1.2159146502473754,-0.111055078195752
543521,498,166.0,56,136,192,1.2280191481437757,-0.09895416825774883
543548,571,190.33333333333334,31,219,250,1.3141103242338046,-0.012888510909663031
543606,1057,352.3333333333333,127,337,464,1.3163905241649985,-0.010608986864619752
543699,1195,398.3333333333333,122,453,575,1.410751044658376,0.08372356372659762
543766,457,152.33333333333334,76,165,241,1.4559496763440014,0.12890879784617093
544727,520,173.33333333333334,90,168,258,1.4121043137713984,0.0850764317099475
544931,1196,398.6666666666667,102,351,453,1.1818102493401819,-0.14514937003665795
545333,1590,530.0,176,435,611,1.1859960817249646,-0.14096477839664479
545343,26,8.666666666666666,4,6,10,1.3053485438033523,-0.021647694214324664
547001,64,21.333333333333332,4,14,18,1.2511994480970867,-0.07578073930004425
547942,227,75.66666666666667,22,69,91,1.2748764082207982,-0.05211079738961355
547943,1234,411.3333333333333,64,374,438,1.1270822114386632,-0.19986118571030498
547973,446,148.66666666666666,72,84,156,1.1763795552352092,-0.15057845440079842
548384,124,41.333333333333336,14,40,54,1.3129979871810349,-0.014000518248709515
548389,896,298.6666666666667,69,309,378,1.2810900078406031,-0.045899039575815204
552640,358,119.33333333333333,30,134,164,1.3426766781605506,0.015669375512662453
554340,363,121.0,24,102,126,1.1862774813233736,-0.14068346220938266
554430,1566,522.0,131,488,619,1.2125623894133835,-0.11440634536833705
554431,147,49.0,21,38,59,1.2856533130994598,-0.0413370869504639
570240,644,214.66666666666666,74,212,286,1.3255746267605755,-0.0014276065775853386
570257,81,27.0,7,26,33,1.2996441616273067,-0.027350385524205878
570488,191,63.666666666666664,32,70,102,1.4064065521181246,0.07938035896041384
570632,998,332.6666666666667,101,349,450,1.3417433207056668,0.014736294719210452
570663,500,166.66666666666666,62,148,210,1.2847338663921022,-0.04225626111974834
570666,509,169.66666666666666,62,167,229,1.3342391792102999,0.007234377566209593
571510,1413,471.0,137,470,607,1.294634896233667,-0.03235816609493236
571521,59,19.666666666666668,15,16,31,1.347935711971605,0.020926850465622815
571578,1620,540.0,160,507,667,1.2512653278646597,-0.07571487906024243
571656,508,169.33333333333334,76,170,246,1.3913209886525981,0.06429926708673483
571666,1259,419.6666666666667,109,433,542,1.297257332284971,-0.029736507373801846
571670,491,163.66666666666666,38,155,193,1.2409061948458073,-0.08607094147355454
571676,49,16.333333333333332,11,25,36,1.4101409849515318,0.08311368485078563
571710,534,178.0,69,149,218,1.263859499525597,-0.06312444050449906
571735,265,88.33333333333333,21,100,121,1.3365459373028812,0.009540451900394764
571760,1157,385.6666666666667,108,386,494,1.289798181508284,-0.037193447144060254
571882,244,81.33333333333333,51,92,143,1.480638054644976,0.15358985813404047
571901,243,81.0,21,91,112,1.3402340393266963,0.013227460714335448
571927,1209,403.0,126,421,547,1.3466215624497218,0.019613090477766493
571945,1198,399.3333333333333,60,412,472,1.2158128662165701,-0.11115683205621307
571946,186,62.0,41,92,133,1.5745760411675611,0.24750000000000005
571948,79,26.333333333333332,11,33,44,1.372619144107637,0.045602966054668626
572020,1029,343.0,112,312,424,1.2585664820420694,-0.06841588905665175
572070,568,189.33333333333334,82,180,262,1.3550001264894138,0.027989170982870126
572125,113,37.666666666666664,19,28,47,1.3004325177584866,-0.02656226307384668
572143,375,125.0,54,141,195,1.4322045297866273,0.10517068971358001
572193,388,129.33333333333334,46,111,157,1.2657714374321614,-0.06121306932558612
572955,237,79.0,35,64,99,1.2922978026519207,-0.034694566926378956
572971,1372,457.3333333333333,137,469,606,1.322756653095435,-0.004244744952211388
573009,32,10.666666666666666,8,14,22,1.3692461778214635,0.04223099956731491
573062,24,8.0,8,5,13,1.3321737012183772,0.005169511813569283
573124,538,179.33333333333334,29,166,195,1.1856453086258656,-0.1413154475212297
573186,1026,342.0,105,351,456,1.3281048888501066,0.001101905503544831
573204,122,40.666666666666664,15,38,53,1.312293420811701,-0.014704875773790427
573668,227,75.66666666666667,38,77,115,1.3881144610154754,0.06109368991346931
579328,808,269.3333333333333,90,288,378,1.373737332710547,0.04672082320936655
592094,225,75.0,37,72,109,1.364095712882149,0.03708206130461966
592135,449,149.66666666666666,62,139,201,1.329639601922022,0.0026361636630218843
592145,305,101.66666666666667,56,112,168,1.459177833064849,0.13213599769197004
592169,335,111.66666666666667,42,121,163,1.3801605301392694,0.05314211670408442
592222,503,167.66666666666666,44,197,241,1.3824998193249995,0.055480712488704675
592233,214,71.33333333333333,16,71,87,1.2822193478761155,-0.04477003429397031
592254,87,29.0,22,35,57,1.4291286781318966,0.1020957497883459
592288,53,17.666666666666668,4,13,17,1.274505047622447,-0.05248204791100086
592314,1130,376.6666666666667,128,330,458,1.2422454872177544,-0.08473204608836027
592332,1248,416.0,112,407,519,1.2642242429364774,-0.0627598052091467
592346,376,125.33333333333333,56,132,188,1.4036222346769789,0.0765968668335626
592351,1261,420.3333333333333,138,436,574,1.3531944995293945,0.02618407923831123
592390,407,135.66666666666666,58,126,184,1.3355781812894798,0.008572982744684099
592426,483,161.0,64,183,247,1.4336867772564388,0.10665249782256048
592464,47,15.666666666666666,5,29,34,1.4031652980974985,0.07614006569707632
592473,355,118.33333333333333,25,117,142,1.2615433392861777,-0.06543991419858175
592644,713,237.66666666666666,65,255,320,1.3349658565239748,0.007960839481609305
592662,1193,397.6666666666667,202,359,561,1.3862924375970633,0.059272206570678776
592717,788,262.6666666666667,132,297,429,1.5245314704566582,0.19747026326562778
592741,257,85.66666666666667,43,79,122,1.3571103380361162,0.03009875703058018
592761,828,276.0,116,238,354,1.2933100678650167,-0.03368260176418181
592767,539,179.66666666666666,77,190,267,1.4122836901128404,0.08525575488149717
592773,526,175.33333333333334,83,134,217,1.2714661083707393,-0.05552008637461325
592791,809,269.6666666666667,61,263,324,1.2395856725043366,-0.08739107239199706
592826,995,331.6666666666667,136,339,475,1.3980359665964117,0.07101225460833449
592836,341,113.66666666666667,43,91,134,1.2530902172050302,-0.0738905306449964
592865,260,86.66666666666667,35,100,135,1.4093339803290335,0.08230691943680601
592866,1237,412.3333333333333,134,441,575,1.374750004504424,0.04773319483182803
593140,358,119.33333333333333,55,119,174,1.3817988463149768,0.054779947257808326
593144,538,179.33333333333334,43,155,198,1.1951507242594295,-0.1318128494383095
593334,832,277.3333333333333,82,261,343,1.2625457558123334,-0.06443779480402334
593372,732,244.0,98,240,338,1.3600666009129474,0.033054143625858456
593423,819,273.0,83,289,372,1.3467701249979882,0.01976160898982049
593576,474,158.0,57,139,196,1.274995941232784,-0.05199129980904149
593619,19,6.333333333333333,3,8,11,1.333718404879629,0.006713757601018999
593643,4,1.3333333333333333,2,2,4,1.3313100839229512,0.0043061505075245865
593833,473,157.66666666666666,47,151,198,1.283245838548771,-0.04374384788885721
593958,1165,388.3333333333333,132,389,521,1.3347087973169038,0.007703856470820725
593974,383,127.66666666666667,59,141,200,1.4366781790945422,0.10964301296338519
594056,68,22.666666666666668,9,28,37,1.3602432325047096,0.03323072286131401
594577,370,123.33333333333333,45,130,175,1.3643603688215113,0.037346638795911824
594694,3,1.0,3,6,9,1.3709656772541827,0.043949989314090665
594795,150,50.0,17,45,62,1.2948565633576956,-0.03213656467643111
594798,1588,529.3333333333334,111,385,496,1.0144099993812268,-0.3125
594835,1396,465.3333333333333,104,485,589,1.276909553449424,-0.050078254816344314
594965,396,132.0,66,110,176,1.3240121916521175,-0.0029895785563691657
594985,35,11.666666666666666,2,14,16,1.3194347522679717,-0.007565661117438394
594986,235,78.33333333333333,35,77,112,1.3568873399453452,0.02987582503985542
594987,245,81.66666666666667,32,77,109,1.3223693162061527,-0.004631967028912776
595014,562,187.33333333333334,68,154,222,1.239768671950966,-0.08720812718920379
595411,46,15.333333333333334,4,17,21,1.3205037651993459,-0.00649696505785502
595465,352,117.33333333333333,51,102,153,1.3098914519198928,-0.01710613268526462
595918,315,105.0,37,111,148,1.3561261277665004,0.029114838495948314
595928,167,55.666666666666664,12,58,70,1.2983080039367394,-0.028686147157188202
596001,1225,408.3333333333333,115,472,587,1.4068812806659858,0.0798549467914691
596027,107,35.666666666666664,31,30,61,1.3969812333124694,0.06995783396347677
596049,2,0.6666666666666666,1,4,5,1.3450934944841688,0.01808547545494088
596057,695,231.66666666666666,71,250,321,1.3594527957207514,0.03244052037491363
596112,312,104.0,38,96,134,1.3035038841896698,-0.023491807042671065
596133,872,290.6666666666667,94,311,405,1.3683352133799302,0.041320305149581404
596295,485,161.66666666666666,64,152,216,1.3264320233562017,-0.0005704641274297817
598264,547,182.33333333333334,90,136,226,1.271779147448759,-0.05520714008616623
598286,303,101.0,37,98,135,1.32419922236623,-0.00280260328102222
598287,520,173.33333333333334,55,166,221,1.292598958139338,-0.03439350070605651
601713,976,325.3333333333333,120,337,457,1.3782231786921355,0.05120533951756445
605130,424,141.33333333333334,56,134,190,1.3299289652184763,0.002925441187767275
605135,974,324.6666666666667,99,301,400,1.2565569464019155,-0.07042482903969227
605138,97,32.333333333333336,16,35,51,1.3652902898012644,0.03827628413285722
605151,503,167.66666666666666,60,165,225,1.3298583507985848,0.0028548476990704064
605164,1330,443.3333333333333,140,466,606,1.3547067701656808,0.027695901614440244
605177,404,134.66666666666666,54,124,178,1.3183626646020277,-0.00863743100019354
605195,387,129.0,66,113,179,1.350294368494706,0.023284807846838618
605200,1031,343.6666666666667,115,343,458,1.3276600272776378,0.0006571757948532486
605218,222,74.0,46,54,100,1.3277820288159468,0.0007791411700395212
605242,580,193.33333333333334,67,215,282,1.399234279487988,0.07221021230163327
605280,305,101.66666666666667,64,111,175,1.488596657235043,0.16154610167251904
605288,680,226.66666666666666,84,230,314,1.3588942064004828,0.031882096629066936
605309,283,94.33333333333333,32,72,104,1.2280540077153894,-0.09891931901904538
605347,774,258.0,93,307,400,1.4690233809718147,0.14197862722788135
605359,297,99.0,39,91,130,1.3142041555604327,-0.01279470739607591
605397,1147,382.3333333333333,85,374,459,1.2306001346904034,-0.0963739467550273
605400,1638,546.0,165,462,627,1.1816343038815225,-0.14532526334239093
605447,146,48.666666666666664,23,39,62,1.304191744783704,-0.02280415034104255
605452,386,128.66666666666666,54,150,204,1.4463531767334576,0.11931514278495547
605483,1147,382.3333333333333,149,301,450,1.2132460387044315,-0.11372289872140007
605488,324,108.0,46,122,168,1.421345826579773,0.0943152051925138
605501,136,45.333333333333336,29,62,91,1.4878126218964616,0.16076229873400893
605513,794,264.6666666666667,102,276,378,1.3897265780689954,0.06270532911082638
605521,22,7.333333333333333,4,2,6,1.2896146654277247,-0.037376908827644995
605525,263,87.66666666666667,28,63,91,1.2065620402157935,-0.12040491597060865
605538,403,134.33333333333334,42,129,171,1.2941190795080981,-0.032873829924530584
605540,968,322.6666666666667,80,258,338,1.1269397596127966,-0.20000359531127065
606149,404,134.66666666666666,29,88,117,1.0932229669610276,-0.23371039378977
606160,211,70.33333333333333,17,65,82,1.2642251140241778,-0.06275893437964997
606213,3,1.0,2,3,5,1.3418273461876975,0.014820295294802444
606303,81,27.0,12,25,37,1.3241425236945326,-0.0028592851463657976
606424,453,151.0,54,126,180,1.2503679773670036,-0.07661196356947997
606625,374,124.66666666666667,64,79,143,1.2347567327543223,-0.09221858077037792
606930,341,113.66666666666667,51,121,172,1.4051249489174917,0.07809913564658033
606965,390,130.0,39,140,179,1.3452233397746713,0.018215282257312282
607074,631,210.33333333333334,86,181,267,1.2873303167420824,-0.039660580397382184
607179,55,18.333333333333332,10,12,22,1.3013489898559394,-0.025646062632747046
607192,910,303.3333333333333,112,227,339,1.1787755346776951,-0.148183185163282
607200,645,215.0,86,220,306,1.3812520127439925,0.05423327577666193
607219,553,184.33333333333334,61,202,263,1.3792508093109306,0.05223266553091954
607229,522,174.0,58,191,249,1.3800638215403904,0.05304543677111395
607231,714,238.0,124,194,318,1.3284332785078878,0.0014301978216064715
607237,456,152.0,73,130,203,1.3258151713207529,-0.0011871333184965138
607374,323,107.66666666666667,40,108,148,1.341301607311694,0.014294712255846553
607391,169,56.333333333333336,23,77,100,1.449569769232087,0.12253078183634858
607468,11,3.6666666666666665,3,2,5,1.3162582994553385,-0.010741172380852593
607481,386,128.66666666666666,48,112,160,1.280279649546804,-0.046709157667016
607536,1174,391.3333333333333,134,410,544,1.3707124546070533,0.04369684172602861
607560,242,80.66666666666667,18,87,105,1.31002675590364,-0.01697086880768839
607572,186,62.0,37,59,96,1.3879676841309383,0.0609469565358467
607644,811,270.3333333333333,58,233,291,1.1563943406317367,-0.17055774508085264
608032,327,109.0,35,117,152,1.350318371514035,0.023308803751305396
608328,92,30.666666666666668,14,37,51,1.3789206027572118,0.05190255685547607
608331,871,290.3333333333333,101,300,401,1.3600281133182994,0.033015667439522556
608334,287,95.66666666666667,62,110,172,1.5141701075839096,0.18711197165938231
608335,83,27.666666666666668,15,28,43,1.3553560661887876,0.028345005176270588
608337,1449,483.0,196,412,608,1.271162949076973,-0.055823155807325886
608344,326,108.66666666666667,24,129,153,1.3562385520613591,0.029227229466525895
608349,251,83.66666666666667,36,63,99,1.2648783069839922,-0.06210593503622408
608371,307,102.33333333333333,53,79,132,1.3042268496782583,-0.022769055852116082
608379,832,277.3333333333333,101,296,397,1.3931036680328697,0.06608141805355983
608566,1535,511.6666666666667,142,507,649,1.2782005993707968,-0.048787591580737866
608638,190,63.333333333333336,17,59,76,1.2785008624745193,-0.04848741747959395
608648,386,128.66666666666666,37,109,146,1.227438072714687,-0.09953507144718876
608652,166,55.333333333333336,24,49,73,1.3162234431289621,-0.010776018375280527
608665,209,69.66666666666667,24,67,91,1.312019028217013,-0.014979187034314556
608716,289,96.33333333333333,35,79,114,1.260485573041349,-0.06649736690530994
608717,825,275.0,105,298,403,1.4155960338294171,0.08856711676871143
608718,533,177.66666666666666,30,175,205,1.2237926148786942,-0.103179448713697
608723,383,127.66666666666667,40,131,171,1.3268059254327578,-0.0001966728811706453
612434,608,202.66666666666666,105,187,292,1.3902076261918468,0.06318623464365314
613534,164,54.666666666666664,30,43,73,1.3208189653932783,-0.006181858294083131
614179,203,67.66666666666667,31,81,112,1.4278555657278278,0.10082301475427458
615698,486,162.0,44,169,213,1.3148919012963018,-0.012107165518566498
617228,59,19.666666666666668,6,20,26,1.3158726916738293,-0.01112666586231481
621052,162,54.0,45,33,78,1.3517242772581284,0.024714292763423185
621056,272,90.66666666666667,30,91,121,1.3228041223143632,-0.004197289803886228
621076,65,21.666666666666668,8,14,22,1.2738844423428644,-0.05310246923368234
621078,63,21.0,8,22,30,1.3301501396648066,0.0031465500746072905
621107,1247,415.6666666666667,97,445,542,1.3066587204304505,-0.020337905943626833
621111,1362,454.0,104,356,460,1.0828845289717213,-0.24404576730785954
621121,715,238.33333333333334,98,198,296,1.2685234049290208,-0.058461917554002873
621129,102,34.0,15,34,49,1.3401811831407462,0.01317462019576765
621139,15,5.0,9,4,13,1.3604624043783842,0.0334498297690915
621219,410,136.66666666666666,44,133,177,1.3050385389987318,-0.02195760712877748
621237,362,120.66666666666667,70,99,169,1.355168809962963,0.028157804456056645
621242,525,175.0,55,146,201,1.221426378798732,-0.10554498340507723
621244,1529,509.6666666666667,157,491,648,1.2806101021711156,-0.04637880299391872
621249,196,65.33333333333333,22,71,93,1.3501393235657044,0.023129808875526514
621295,391,130.33333333333334,35,111,146,1.2197649414207339,-0.10720592830761366
621345,396,132.0,57,127,184,1.3538322030741152,0.02682159375794324
621348,44,14.666666666666666,6,17,23,1.339586054346286,0.012579667806588812
621366,400,133.33333333333334,52,132,184,1.3471369299676768,0.02012830523290332
621368,129,43.0,32,41,73,1.4067732232235317,0.07974692137889439
621532,6,2.0,1,3,4,1.3248914817653648,-0.002110549078166324
621593,32,10.666666666666666,3,9,12,1.3011925271784852,-0.0258024789322695
622065,455,151.66666666666666,47,148,195,1.2995666966724149,-0.027427827517299663
622072,759,253.0,61,263,324,1.292657912853097,-0.03433456346737662
622075,273,91.0,36,104,140,1.4044627540048824,0.07743713701867594
622088,190,63.333333333333336,26,35,61,1.2033541592730468,-0.12361184604835773
622092,180,60.0,37,52,89,1.3664466634398302,0.039432315004581886
622098,121,40.333333333333336,7,49,56,1.3317568702076472,0.004752804357929241
622250,103,34.333333333333336,12,30,42,1.2965334105832387,-0.03046021449406444
622251,198,66.0,37,61,98,1.3704081771165637,0.04339265442804319
622253,156,52.0,17,49,66,1.302347083718585,-0.024648264620394933
622256,14,4.666666666666667,7,7,14,1.3707750032144093,0.04375937179302025
622491,1440,480.0,171,445,616,1.2903320950350152,-0.03665969187746798
622503,89,29.666666666666668,7,30,37,1.302863837025371,-0.024131664487196502
622608,1035,345.0,117,405,522,1.4569616295680994,0.12992045111184858
622694,522,174.0,54,180,234,1.33171980113732,0.004715746275441468
622766,123,41.0,19,34,53,1.3098259091753937,-0.0171716560018913
622780,45,15.0,17,14,31,1.3895177040301467,0.06249651698543901
623149,274,91.33333333333333,32,102,134,1.3760449916400685,0.04902779811346991
623167,202,67.33333333333333,26,89,115,1.4449272196195535,0.1178896083465597
623352,620,206.66666666666666,68,110,178,1.0415757271028465,-0.28534232461576137
623354,56,18.666666666666668,6,18,24,1.3114573402185377,-0.015540708539872217
623364,144,48.0,15,39,54,1.2654969052380018,-0.061487520144202445
623470,210,70.0,38,75,113,1.4165519701620501,0.08952276974718787
623485,37,12.333333333333334,3,17,20,1.3404319003170542,0.013425263055668157
624133,240,80.0,23,93,116,1.3649257691594805,0.0379118715405693
624418,136,45.333333333333336,30,48,78,1.4162304852272851,0.08920138010547696
624522,45,15.0,8,11,19,1.3101926134589856,-0.016805060415060247
624586,74,24.666666666666668,13,18,31,1.3060594997219181,-0.02093694903397192
624647,116,38.666666666666664,11,31,42,1.2644182929394094,-0.0625658127256048
626929,171,57.0,24,75,99,1.4393958335701074,0.1123598618845787
628317,1193,397.6666666666667,111,343,454,1.1858964733469783,-0.14106435724918365
628452,546,182.0,47,155,202,1.1977048937076966,-0.12925943708495025
628711,644,214.66666666666666,52,176,228,1.1603055704644436,-0.16664767459651708
640444,103,34.333333333333336,23,47,70,1.460650830436464,0.1336085584446245
640448,139,46.333333333333336,20,42,62,1.3208563386380876,-0.006144496127275412
640455,914,304.6666666666667,60,296,356,1.2137648715933738,-0.11320421962246496
640462,44,14.666666666666666,8,11,19,1.3130859652122686,-0.013912566295510409
640470,248,82.66666666666667,32,66,98,1.266088112466925,-0.06089648815814863
641154,867,289.0,71,289,360,1.267884167411303,-0.05910096559193878
641302,330,110.0,21,136,157,1.3651378356140573,0.03812387513540383
641312,349,116.33333333333333,50,133,183,1.4338372441858964,0.10680292015131765
641360,15,5.0,1,13,14,1.3675407363642043,0.04052606362899991
641386,39,13.0,6,19,25,1.3679404926572318,0.04092570142814522
641394,72,24.0,15,13,28,1.2927743496092365,-0.03421816122487353
641401,96,32.0,11,26,37,1.2847982090584849,-0.04219193752551664
641420,30,10.0,4,14,18,1.3481411125168492,0.021132190127002293
641447,140,46.666666666666664,18,51,69,1.3567129636578144,0.02970150044012443
641482,247,82.33333333333333,41,103,144,1.4784394405257146,0.151391895717647
641540,244,81.33333333333333,30,78,108,1.3197995291053775,-0.007200992405469009
641541,124,41.333333333333336,19,52,71,1.4087135582372547,0.0816866812476289
641576,6,2.0,2,5,7,1.3465871859126874,0.01957872413046391
641582,129,43.0,13,34,47,1.2617456242993077,-0.06523768914582506
641645,6,2.0,1,3,4,1.3248914817653648,-0.002110549078166324
641682,41,13.666666666666666,7,13,20,1.328512411828046,0.0015093076854377774
641703,13,4.333333333333333,3,5,8,1.3313532513181041,0.004349305107200996
641729,451,150.33333333333334,59,150,209,1.3544593382843229,0.027448543075678122
641743,157,52.333333333333336,28,60,88,1.4166885033977974,0.08965926251239487
641745,1230,410.0,158,405,563,1.3586551249586594,0.03164308605464128
641755,312,104.0,64,92,156,1.3950651707375061,0.06804233933878012
641771,440,146.66666666666666,76,144,220,1.4108889272745284,0.08386140547223286
641778,868,289.3333333333333,103,336,439,1.45250730612166,0.12546744799503795
641793,227,75.66666666666667,27,88,115,1.3881144610154754,0.06109368991346931
641816,1025,341.6666666666667,120,355,475,1.368784857307655,0.041769815795965615
641835,298,99.33333333333333,40,100,140,1.3547879593049694,0.02777706668802571
641851,142,47.333333333333336,18,45,63,1.3191088460399654,-0.007891470741851814
641871,160,53.333333333333336,29,39,68,1.3037369779222037,-0.023258782402686196
641927,12,4.0,1,6,7,1.3273881061528428,0.00038533527164053005
641941,533,177.66666666666666,49,139,188,1.1696426384928906,-0.1573133742179076
642003,213,71.0,29,74,103,1.361473042787126,0.03446016860914436
642068,55,18.333333333333332,7,12,19,1.281945273207742,-0.045044027722418
642083,187,62.333333333333336,15,69,84,1.325218155877768,-0.001783971796968542
642092,168,56.0,16,63,79,1.3428648949690853,0.01585753653085531
642121,146,48.666666666666664,26,34,60,1.2933775955294409,-0.03361509411599051
642130,79,26.333333333333332,12,21,33,1.3049724428594605,-0.022023683676141603
642152,553,184.33333333333334,79,154,233,1.2856790504085103,-0.04131135727034585
642203,133,44.333333333333336,18,40,58,1.31333576575755,-0.01366283979493299
642207,181,60.333333333333336,27,45,72,1.2776641919860585,-0.04932383996611933
642232,1199,399.6666666666667,85,403,488,1.244910610357887,-0.0820677129315075
642233,145,48.333333333333336,15,53,68,1.339047636045621,0.012041409101346545
642397,301,100.33333333333333,59,111,170,1.4758532815306864,0.14880650329971767
642528,325,108.33333333333333,42,109,151,1.3499104244399858,0.02290097759901122
642545,742,247.33333333333334,87,252,339,1.3508552679610575,0.023845541054005492
642547,757,252.33333333333334,114,198,312,1.2639961676403018,-0.06298781290031452
642701,121,40.333333333333336,22,53,75,1.4393388183056306,0.11230286352029872
643256,484,161.33333333333334,33,175,208,1.3010368172533489,-0.02595814270260144
643290,290,96.66666666666667,66,65,131,1.3316611227542456,0.004657085285537876
643316,407,135.66666666666666,60,131,191,1.3613188801473335,0.03430605166551737
643327,902,300.6666666666667,138,337,475,1.497223105471721,0.17016999289793944
643338,615,205.0,46,174,220,1.1697298636767384,-0.15722617488893897
643511,223,74.33333333333333,15,73,88,1.2687030663329177,-0.05828230940449508
643615,138,46.0,22,47,69,1.3616750772011768,0.034662143137103474
643778,345,115.0,50,99,149,1.3061362752254295,-0.020860196287894706
645261,1007,335.6666666666667,132,300,432,1.2950740509746252,-0.031919141526159045
647315,49,16.333333333333332,6,14,20,1.3052982706133838,-0.021697952502550466
650347,9,3.0,1,6,7,1.336918721562012,0.009913125660566902
650382,164,54.666666666666664,49,49,98,1.4517481672787742,0.12470853417252137
650496,15,5.0,1,1,2,1.282600752534364,-0.044388742689898786
650530,141,47.0,28,47,75,1.3869829151510449,0.059962479456547646
650556,115,38.333333333333336,25,32,57,1.3527380458165095,0.025727760825291268
650633,153,51.0,21,56,77,1.3680380025217742,0.041023182389271495
650644,610,203.33333333333334,50,193,243,1.243195257660945,-0.08378255717166216
650671,105,35.0,25,38,63,1.4140958146036815,0.08706734223091028
650828,216,72.0,13,72,85,1.2685124884317562,-0.058472830815450516
650893,210,70.0,39,60,99,1.3486818110422802,0.021672728381116668
650895,518,172.66666666666666,59,137,196,1.2144671471866484,-0.11250215219442228
656061,30,10.0,6,7,13,1.3139592069647767,-0.013039583385219933
656186,169,56.333333333333336,38,41,79,1.340540910412784,0.013534240839137457
656232,164,54.666666666666664,25,62,87,1.3941393184491562,0.06711676148721546
656266,25,8.333333333333334,2,14,16,1.349848481396252,0.0228390529161433
656288,550,183.33333333333334,71,182,253,1.352278057555812,0.025267908912152803
656302,547,182.33333333333334,93,177,270,1.4098792115659073,0.0828519890587982
656322,192,64.0,25,64,89,1.339155422357372,0.012149163463585744
656353,23,7.666666666666667,5,8,13,1.3352586601556562,0.008253556321813793
656420,101,33.666666666666664,17,17,34,1.2545449257753698,-0.07243625327253689
656427,1374,458.0,147,362,509,1.158049006770612,-0.16890356941034046
656458,25,8.333333333333334,4,11,15,1.3429333090295996,0.015925930312395087
656464,179,59.666666666666664,29,60,89,1.3687712296671657,0.04175619219491744
656529,68,22.666666666666668,15,32,47,1.4231589130547468,0.09612775424091313
656546,420,140.0,71,170,241,1.5209451817634316,0.1938850376032466
656548,54,18.0,11,13,24,1.3171244798655948,-0.009875248719724006
656557,81,27.0,10,21,31,1.2873949805936937,-0.03959593571312592
656605,334,111.33333333333333,57,133,190,1.491061151438135,0.16400986536181783
656629,136,45.333333333333336,12,45,57,1.3005978029155383,-0.02639702690984458
656638,40,13.333333333333334,4,19,23,1.351524561461467,0.02451463616558014
656685,285,95.0,26,104,130,1.3369337581977154,0.00992815783918144
656686,84,28.0,19,32,51,1.401304375440839,0.07427969464636774
656725,115,38.333333333333336,21,52,73,1.444371060874818,0.11733361445578616
656730,6,2.0,1,2,3,1.3176595803829239,-0.009340306814376254
656756,388,129.33333333333334,34,130,164,1.2921259109939538,-0.034866407633028285
656793,93,31.0,18,32,50,1.3701946751584013,0.043179215755128286
656794,796,265.3333333333333,125,241,366,1.3575398827617053,0.030528174432539634
656849,279,93.0,41,81,122,1.3137035582210825,-0.013295156350714654
656876,98,32.666666666666664,19,30,49,1.350758179070034,0.023748480941614858
656887,253,84.33333333333333,50,81,131,1.4061085803898157,0.07908247555548464
656945,359,119.66666666666667,71,118,189,1.438606052283769,0.11157031470149859
656954,428,142.66666666666666,60,167,227,1.4562156096504626,0.12917465232593095
656970,213,71.0,21,76,97,1.3325261624056184,0.005521868525921292
656981,6,2.0,1,1,2,1.310427679000483,-0.016570064550586183
657006,41,13.666666666666666,5,9,14,1.2884971762999664,-0.038494066714526154
657024,237,79.0,19,75,94,1.269071828334415,-0.05791365670969806
657031,211,70.33333333333333,29,73,102,1.3610260581124631,0.03401331642757888
657044,151,50.333333333333336,13,48,61,1.2871848294371089,-0.039806024577692334
657097,176,58.666666666666664,21,57,78,1.3193658430777138,-0.007634549881957886
657140,205,68.33333333333333,43,71,114,1.4329779867630736,0.10594391742554321
657141,287,95.66666666666667,44,98,142,1.3848279225698934,0.057808125648172615
657240,52,17.333333333333332,7,12,19,1.2902907519224396,-0.036701022735312394
657277,426,142.0,54,163,217,1.4237687497163258,0.09673741013757398
657610,273,91.0,27,114,141,1.408862686350788,0.0818357651573074
657612,375,125.0,32,119,151,1.263800380004373,-0.06318354250179237
658551,61,20.333333333333332,12,24,36,1.3741242557488818,0.04710763155779207
659275,468,156.0,56,125,181,1.2323992221481124,-0.09457539257436998
660271,266,88.66666666666667,56,64,120,1.3301197936629243,0.0031162130677442335
660365,83,27.666666666666668,13,26,39,1.3309573256515062,0.003953496799028899
660546,7,2.3333333333333335,6,1,7,1.3433488637444162,0.016341361850435554
660600,77,25.666666666666668,22,26,48,1.4029698404194015,0.07594466595562599
660623,208,69.33333333333333,24,68,92,1.3190096550618982,-0.007990632318195301
660761,278,92.66666666666667,41,128,169,1.5209076408294473,0.1938475077969697
660813,105,35.0,6,35,41,1.2856483292400642,-0.041342069332567455
660825,9,3.0,2,1,3,1.3081988155601667,-0.018798267321673112
660853,93,31.0,14,37,51,1.3761728111355525,0.04915557972129947
660896,134,44.666666666666664,15,34,49,1.2611768847667826,-0.06580626009525004
661255,308,102.66666666666667,27,98,125,1.2731117061006876,-0.0538749764250126
661269,15,5.0,2,2,4,1.2967574165060038,-0.03023627497008241
661403,139,46.333333333333336,16,42,58,1.2989516798383332,-0.02804266205098105
663399,25,8.333333333333334,6,12,18,1.3636788261295563,0.0366652981236395
663423,555,185.0,72,201,273,1.4075146484708854,0.08048812685645967
663432,283,94.33333333333333,69,76,145,1.4058436919559953,0.07881766563864923
663460,237,79.0,35,73,108,1.3341045564234313,0.0070997946835951176
663465,332,110.66666666666667,50,127,177,1.4424427874747339,0.11540591262544408
663474,207,69.0,42,46,88,1.3016655609296768,-0.025329585395519993
663531,158,52.666666666666664,27,73,100,1.477700434510923,0.15065310875554627
663554,259,86.33333333333333,33,84,117,1.330585240223796,0.0035815216631331914
663556,80,26.666666666666668,7,24,31,1.2900286129300806,-0.03696308402566295
663734,73,24.333333333333332,15,29,44,1.3897117653092645,0.06269052074182424
663738,24,8.0,5,18,23,1.4014851918531428,0.0744604574619201
663765,102,34.0,12,35,47,1.3284355619483172,0.0014324805851892997
663770,24,8.0,2,6,8,1.2975179559009946,-0.0294759610106059
663776,291,97.0,41,96,137,1.355478865149391,0.02846776773738302
663855,350,116.66666666666667,64,89,153,1.3133438556346069,-0.013654752315839458
663878,61,20.333333333333332,18,18,36,1.3741242557488818,0.04710763155779207
663903,332,110.66666666666667,42,106,148,1.325006726960994,-0.001995338042976469
663959,13,4.333333333333333,1,6,7,1.3242413591095512,-0.00276047902767651
663978,726,242.0,53,212,265,1.174276792467348,-0.15268059387759902
663986,53,17.666666666666668,12,20,32,1.3719437805443608,0.04492780267948682
664042,192,64.0,34,64,98,1.3840933581571873,0.05707377897159849
664054,171,57.0,15,61,76,1.3203951630317443,-0.00660553503411232
664074,65,21.666666666666668,7,21,28,1.31187285737134,-0.015125314552712155
664076,20,6.666666666666667,5,10,15,1.3585914659679854,0.0315794459334664
664092,63,21.0,11,31,42,1.406449022346371,0.07942281659983474
664126,176,58.666666666666664,29,59,88,1.37066291821483,0.043647320017150104
664129,177,59.0,40,74,114,1.501467949763499,0.17441357895291554
664141,305,101.66666666666667,30,111,141,1.3457052255512438,0.01869702519556693
664157,114,38.0,24,31,55,1.3438493557728382,0.016841705525361794
664192,963,321.0,107,313,420,1.310369881109644,-0.01662784530924588
664199,457,152.33333333333334,55,156,211,1.3520030139394712,0.024992946822948614
664208,365,121.66666666666667,48,138,186,1.415821116679513,0.08879213290080634
664285,547,182.33333333333334,86,175,261,1.3816314711783089,0.05461262173369197
664299,319,106.33333333333333,41,72,113,1.2044084093872243,-0.12255790843004588
664337,49,16.333333333333332,8,9,17,1.285640261674981,-0.041350134506300984
664353,375,125.0,26,109,135,1.2025625073562805,-0.12440326330738216
664714,89,29.666666666666668,4,41,45,1.351073194300126,0.024063402796372424
664852,8,2.6666666666666665,3,3,6,1.332928877734524,0.0059244644838412075
664854,224,74.66666666666667,32,64,96,1.3046232105527615,-0.02237281246504108
664875,16,5.333333333333333,4,9,13,1.3572600253615204,0.030248399986370522
664918,49,16.333333333333332,13,12,25,1.338061618844055,0.011055684170367064
664948,111,37.0,9,44,53,1.3400626235992108,0.013056095797094436
665152,171,57.0,28,62,90,1.3928303537942262,0.06580818482943873
665620,128,42.666666666666664,10,45,55,1.3088029951972522,-0.018194266772677103
665733,28,9.333333333333334,6,19,25,1.4023872829099984,0.07536228112518284
665759,33,11.0,8,11,19,1.3457772474738081,0.018769025769731273
665854,47,15.666666666666666,9,17,26,1.3505139362747955,0.023504310543678297
666120,262,87.33333333333333,36,71,107,1.2799139474401589,-0.04707475137396089
666129,31,10.333333333333334,6,12,18,1.3450759618842165,0.01806794805191947
666200,306,102.0,33,101,134,1.3144450001267585,-0.012553934219764917
666201,18,6.0,2,2,4,1.2876430515081945,-0.03934793833064032
666619,6,2.0,2,5,7,1.3465871859126874,0.01957872413046391
666808,32,10.666666666666666,4,12,16,1.3284139874356764,0.001410912467564085
667297,17,5.666666666666667,2,2,4,1.2906669039531435,-0.03632498220182634
667463,108,36.0,7,46,53,1.3478411934399075,0.020832359950664348
667465,25,8.333333333333334,8,16,24,1.4051698603294698,0.07814403374612877
667498,183,61.0,25,77,102,1.4254175481572227,0.09838571984938338
668676,677,225.66666666666666,57,193,250,1.185825173191241,-0.14113563627046366
668678,535,178.33333333333334,74,143,217,1.2593418792677318,-0.06764072167059187
668687,108,36.0,29,29,58,1.376864351401752,0.04984691500438232
668941,59,19.666666666666668,5,28,33,1.3607609200907154,0.03374825699679773
669060,198,66.0,28,82,110,1.429732994882517,0.10269988741023428
669135,12,4.0,3,6,9,1.3416456900365272,0.01463869298929521
669145,151,50.333333333333336,15,64,79,1.383642912635075,0.05662346696843179
669160,347,115.66666666666667,27,103,130,1.2272661883048392,-0.09970690490786738
669203,601,200.33333333333334,59,174,233,1.2245671048638922,-0.10240518829918166
669211,121,40.333333333333336,13,45,58,1.3430812857969086,0.016073863217125783
669212,7,2.3333333333333335,2,8,10,1.3649923932680446,0.037978475900728004
669294,33,11.0,6,21,27,1.4000969461948642,0.07307262330089737
669302,33,11.0,2,14,16,1.3254073604534122,-0.0015948233044558169
669330,64,21.333333333333332,8,20,28,1.3146473779385193,-0.012351616395884113
669373,243,81.0,34,80,114,1.349438912197343,0.02242960511981207
669432,269,89.66666666666667,35,83,118,1.3153810257581886,-0.011618186040654788
669456,1423,474.3333333333333,110,434,544,1.1843918627239376,-0.1425685218826125
669459,15,5.0,3,4,7,1.3179924124634639,-0.009007573390357848
669622,30,10.0,1,6,7,1.2729409203022897,-0.05404571159988647
669735,47,15.666666666666666,8,12,20,1.3110254149077685,-0.01597250582137022
669952,37,12.333333333333334,5,11,16,1.3135157306609337,-0.01348292823590036
670056,118,39.333333333333336,14,32,46,1.2823959848022908,-0.0445934497256828
670090,25,8.333333333333334,6,14,20,1.3775091708628608,0.050491543331135924
670280,111,37.0,13,35,48,1.3112069621215983,-0.01579101242091241
670550,36,12.0,7,17,24,1.370421945772582,0.04340641900282116
670912,136,45.333333333333336,25,48,73,1.3886988942006786,0.06167794986373343
670950,922,307.3333333333333,113,316,429,1.371027700717865,0.044011994393069465
670955,30,10.0,4,11,15,1.3276319691856058,0.0006291260196691351
670970,96,32.0,9,40,49,1.356109531999049,0.029098247647736386
670990,73,24.333333333333332,21,15,36,1.3399015283618854,0.012895048310862522
672335,128,42.666666666666664,28,38,66,1.3702751223703815,0.0432596391213238
672578,65,21.666666666666668,13,30,43,1.4068438949425295,0.07981757214971341
672715,97,32.333333333333336,18,33,51,1.3652902898012644,0.03827628413285722
675912,10,3.3333333333333335,2,8,10,1.3552151800148708,0.02820416076317156
675916,164,54.666666666666664,27,24,51,1.205601267734042,-0.12136540366469517
675921,107,35.666666666666664,19,41,60,1.3911653486975761,0.06414367326577697
676051,134,44.666666666666664,11,44,55,1.2943365189971399,-0.032656454887880715
676220,43,14.333333333333334,11,21,32,1.4023080288777094,0.07528305058500173
676424,27,9.0,3,17,20,1.3711878373678903,0.04417208357614122
676477,71,23.666666666666668,5,21,26,1.2829641277776274,-0.04402547515661759
676596,233,77.66666666666667,18,66,84,1.2302394825329208,-0.09673449200969175
676604,109,36.333333333333336,31,30,61,1.3915856987420563,0.0645638987120718
676606,328,109.33333333333333,36,128,164,1.3973437971626939,0.07032029034422815
676684,63,21.0,10,22,32,1.342866620111734,0.01585926116214531
676709,21,7.0,4,10,14,1.3484511663204395,0.021442152025900718
676755,2,0.6666666666666666,1,1,2,1.3231865518720978,-0.0038149736041244164
676831,46,15.333333333333334,8,9,17,1.2941202038532191,-0.032872705912682765
676840,83,27.666666666666668,2,27,29,1.2699604743083024,-0.0570252741440751
676886,15,5.0,2,7,9,1.332149076435104,0.005144894329458749
676969,61,20.333333333333332,11,27,38,1.386894868612066,0.05987445901591015
676979,60,20.0,8,18,26,1.3130659676223495,-0.013932557957837766
677651,175,58.333333333333336,20,42,62,1.2394097927671694,-0.08756689999571865
677960,100,33.333333333333336,11,21,32,1.2452186920245178,-0.08175972258499686
677976,309,103.0,26,120,146,1.3591028224418338,0.0320906508334311
680692,18,6.0,4,11,15,1.3649574463979026,0.037943539389373226
680704,30,10.0,4,5,9,1.2866136825231187,-0.040377002194997624
681911,42,14.0,17,12,29,1.3854553028835812,0.058435319996735346
685503,87,29.0,12,34,46,1.3625734297333956,0.035560229383885256
